Nom station;Capacité de la station;Nombre bornettes libres;Nombre total vélos disponibles;Vélos mécaniques disponibles;Vélos électriques disponibles;Actualisation de la donnée;Nom communes équipées
Benjamin Godard - Victor Hugo;35;31;3;1;2;2023-04-06T13:48:13+02:00;Paris
Mairie de Rosny-sous-Bois;30;22;7;2;5;2023-04-06T13:47:40+02:00;Rosny-sous-Bois
Rouget de L'isle - Watteau;0;0;0;0;0;2023-02-09T10:35:37+01:00;Vitry-sur-Seine
Toudouze - Clauzel;21;16;5;1;4;2023-04-06T13:42:45+02:00;Paris
Cassini - Denfert-Rochereau;25;24;1;1;0;2023-04-06T13:46:30+02:00;Paris
Mairie du 12ème;30;25;2;2;0;2023-04-06T13:48:08+02:00;Paris
Jourdan - Stade Charléty;60;52;6;1;5;2023-04-06T13:48:53+02:00;Paris
Charonne - Robert et Sonia Delaunay;20;18;2;1;1;2023-04-06T13:49:00+02:00;Paris
Basilique;22;13;5;3;2;2023-04-06T13:44:09+02:00;Saint-Denis
Saint-Sulpice;21;1;19;15;4;2023-04-06T13:48:31+02:00;Paris
Messine - Place Du Pérou;12;5;6;3;3;2023-04-06T13:48:32+02:00;Paris
Le Brun - Gobelins;48;46;1;0;1;2023-04-06T13:47:56+02:00;Paris
Harpe - Saint-Germain;45;45;0;0;0;2023-04-06T13:47:05+02:00;Paris
Lacépède - Monge;23;18;4;2;2;2023-04-06T13:48:30+02:00;Paris
Jean Rostand - Paul Vaillant Couturier;0;0;0;0;0;2023-04-05T11:45:11+02:00;Bobigny
André Karman - République;31;10;21;15;6;2023-04-06T13:48:26+02:00;Aubervilliers
Saint-Romain - Cherche-Midi;17;3;12;5;7;2023-04-06T13:46:12+02:00;Paris
Bois de Vincennes - Gare;50;20;27;17;10;2023-04-06T13:46:48+02:00;Nogent-sur-Marne
Pierre et Marie Curie - Maurice Thorez;27;13;14;11;3;2023-04-06T13:48:02+02:00;Ivry-sur-Seine
Place Nelson Mandela;22;17;2;0;2;2023-04-06T13:44:22+02:00;Rueil-Malmaison
Beaux-Arts - Bonaparte;20;1;19;11;8;2023-04-06T13:48:58+02:00;Paris
Grande Armée - Brunel;62;34;26;12;14;2023-04-06T13:48:52+02:00;Paris
Silly - Galliéni;25;14;9;6;3;2023-04-06T13:47:54+02:00;Boulogne-Billancourt
Jouffroy d'Abbans - Wagram;40;11;10;6;4;2023-04-06T13:47:06+02:00;Paris
Bracion - Périphérique;30;30;0;0;0;2023-04-06T13:47:31+02:00;Paris
Morillons - Dantzig;52;51;0;0;0;2023-04-06T13:40:42+02:00;Paris
Square Boucicaut;60;1;57;25;32;2023-04-06T13:47:40+02:00;Paris
Croulebarde - Corvisart;34;12;22;15;7;2023-04-06T13:48:04+02:00;Paris
Vaneau - Sèvres;35;22;11;8;3;2023-04-06T13:48:54+02:00;Paris
Romainville - Vaillant-Couturier;38;36;1;0;1;2023-04-06T13:47:00+02:00;Montreuil
Guersant - Gouvion-Saint-Cyr;36;26;9;6;3;2023-04-06T13:47:14+02:00;Paris
Porte de Saint-Ouen - Bessières;42;33;7;1;6;2023-04-06T13:46:01+02:00;Paris
Thouin - Cardinal Lemoine;17;2;15;4;11;2023-04-06T13:49:03+02:00;Paris
Cambrai - Benjamin Constant;43;32;9;9;0;2023-04-06T13:48:05+02:00;Paris
Froment - Bréguet;43;19;22;18;4;2023-04-06T13:47:48+02:00;Paris
Chazelles - Courcelles;35;25;5;4;1;2023-04-06T13:48:29+02:00;Paris
Boétie - Ponthieu;33;0;31;24;7;2023-04-06T13:49:03+02:00;Paris
Lagny - Victor Basch;26;2;23;4;19;2023-04-06T13:47:12+02:00;Vincennes
Le Brix et Mesmin - Jourdan;21;20;1;0;1;2023-04-06T13:46:20+02:00;Paris
Saint-Cloud - Hippodrome;30;19;11;5;6;2023-04-06T13:48:05+02:00;Paris
Bir Hakeim;33;2;31;27;4;2023-04-06T13:48:34+02:00;Paris
Louis Lejeune - Barbès;25;19;6;1;5;2023-04-06T13:47:19+02:00;Montrouge
Liberté - Vert-de-Maisons;20;3;16;9;7;2023-04-06T13:47:16+02:00;Maisons-Alfort
Général Martial Valin - Pont du Garigliano;16;10;6;4;2;2023-04-06T13:47:19+02:00;Paris
Alibert - Jemmapes;60;58;1;1;0;2023-04-06T13:48:42+02:00;Paris
Rond-point du Dr Albert Schweitzer;22;16;6;0;6;2023-04-06T13:42:43+02:00;Bagneux
Ramponeau - Belleville;44;42;1;0;1;2023-04-06T13:46:14+02:00;Paris
Raspail - Varenne;18;3;13;8;5;2023-04-06T13:47:24+02:00;Paris
Italie - Tolbiac;21;17;3;0;3;2023-04-06T13:48:52+02:00;Paris
Théâtre des Amandiers - Palais des sports;23;17;5;2;3;2023-04-06T13:43:11+02:00;Nanterre
Serrurier;18;17;0;0;0;2023-04-06T13:48:22+02:00;Paris
Vaugirard - Monsieur le Prince;26;19;6;1;5;2023-04-06T13:47:49+02:00;Paris
Raspail Barbès;28;21;6;2;4;2023-04-06T13:39:49+02:00;Montreuil
Michel-Ange - Parent de Rosan;26;15;7;6;1;2023-04-06T13:45:10+02:00;Paris
De Toqueville - Terrasse;30;24;3;0;3;2023-04-06T13:48:56+02:00;Paris
Charlot - Stade Gabriel Voisin;0;0;0;0;0;2023-04-06T13:49:07+02:00;Issy-les-Moulineaux
Jules Guesde - Pont du Port à l'Anglais;30;15;15;13;2;2023-04-06T13:47:09+02:00;Vitry-sur-Seine
Liard - Amiral Mouchez;14;12;2;1;1;2023-04-06T13:41:24+02:00;Paris
Caire - Dussoubs;40;34;5;1;4;2023-04-06T13:45:58+02:00;Paris
Octave Feuillet - Albéric Magnard;21;20;1;0;1;2023-04-06T13:46:43+02:00;Paris
Tour d'Auvergne - Rodier;17;16;1;1;0;2023-04-06T13:40:19+02:00;Paris
Place Georges Guillaumin;29;3;25;9;16;2023-04-06T13:46:28+02:00;Paris
Artois - Berri;23;0;22;10;12;2023-04-06T13:47:56+02:00;Paris
Bellefond - Poissonnière;17;12;5;2;3;2023-04-06T13:45:54+02:00;Paris
Marceau - Chaillot;21;5;16;8;8;2023-04-06T13:43:20+02:00;Paris
Jean Oestreicher - Porte de Champerret;21;19;2;2;0;2023-04-06T13:46:38+02:00;Paris
Regnault - Patay;63;29;33;29;4;2023-04-06T13:46:20+02:00;Paris
Square Louis XVI;29;6;21;8;13;2023-04-06T13:48:17+02:00;Paris
Las Cases - Bourgogne;22;2;19;13;6;2023-04-06T13:48:04+02:00;Paris
Alexandre Parodi - Quai de Valmy;24;22;1;0;1;2023-04-06T13:44:00+02:00;Paris
Félix Ziem - Armand Gauthier;25;19;2;0;2;2023-04-06T13:41:49+02:00;Paris
Gay Lussac - Saint-Jacques;24;6;15;1;14;2023-04-06T13:49:06+02:00;Paris
Abbeville - Faubourg Poissonnière;14;9;4;0;4;2023-04-06T13:46:44+02:00;Paris
Gare de l'Est - Faubourg-Saint-Martin;32;29;2;1;1;2023-04-06T13:47:53+02:00;Paris
Youri Gagarine - Karl Marx;22;22;0;0;0;2023-04-06T13:45:39+02:00;Villejuif
Gare de Nogent-le-Perreux;32;9;20;16;4;2023-04-06T13:44:56+02:00;Nogent-sur-Marne
Ney - Porte de Clignancourt;25;22;2;1;1;2023-04-06T13:39:48+02:00;Paris
Ségur - d'Estrées;19;6;12;7;5;2023-04-06T13:48:13+02:00;Paris
Edgar Quinet - Raspail;46;33;12;3;9;2023-04-06T13:46:21+02:00;Paris
Boulangers - Cardinal Lemoine;20;1;18;10;8;2023-04-06T13:48:17+02:00;Paris
Faubourg Montmartre - La Fayette;35;9;23;20;3;2023-04-06T13:49:04+02:00;Paris
Boudreau - Auber;14;5;8;3;5;2023-04-06T13:46:40+02:00;Paris
Place Jean-Spire-Lemaître;50;42;7;4;3;2023-04-06T13:48:43+02:00;Vincennes
Verger - Colonel Guichard;29;25;4;1;3;2023-04-06T13:47:44+02:00;Issy-les-Moulineaux
Granges aux Belles;27;21;5;1;4;2023-04-06T13:48:52+02:00;Paris
Moulin de Pierre - Abbé Grégoire;0;0;0;0;0;2023-04-06T08:57:47+02:00;Issy-les-Moulineaux
Dunkerque - Rocroy;24;18;4;0;4;2023-04-06T13:48:29+02:00;Paris
Place de la République - Voltaire;19;10;8;7;1;2023-04-06T13:48:14+02:00;Paris
Gabriel Lamé;36;3;32;26;6;2023-04-06T13:48:23+02:00;Paris
Arsène Houssaye - Friedland;29;20;8;1;7;2023-04-06T13:48:45+02:00;Paris
Quai de l'Horloge - Pont Neuf;17;8;8;3;5;2023-04-06T13:45:48+02:00;Paris
Pereire - Ternes;48;41;7;2;5;2023-04-06T13:46:43+02:00;Paris
Ambroise Rendu - Porte Brunet;17;15;2;1;1;2023-04-06T13:48:59+02:00;Paris
Douai - Bruxelles;27;21;6;1;5;2023-04-06T13:49:01+02:00;Paris
Gare Rosny-Bois-Perrier;36;18;16;3;13;2023-04-06T13:43:14+02:00;Rosny-sous-Bois
Gare Saint-Lazare - Isly;27;15;11;3;8;2023-04-06T13:47:55+02:00;Paris
Institut de France;17;0;17;12;5;2023-04-06T13:43:39+02:00;Paris
Porte Pouchet-Bessières;23;19;2;1;1;2023-04-06T13:45:45+02:00;Paris
Vigée-Lebrun - Anselme Payen;24;23;1;1;0;2023-04-06T13:48:27+02:00;Paris
Château - République;26;26;0;0;0;2023-04-06T13:45:37+02:00;Bagnolet
Octave Gréard - Tour Eiffel;33;2;30;25;5;2023-04-06T13:48:12+02:00;Paris
Thionville - Ourcq;24;22;0;0;0;2023-04-06T13:47:48+02:00;Paris
Institut du Monde Arabe - Saint-Germain;40;40;0;0;0;2023-04-06T13:45:12+02:00;Paris
Legendre - Clichy;40;35;2;1;1;2023-04-06T13:48:26+02:00;Paris
Henri Barbusse - Stalingrad;16;8;7;2;5;2023-04-06T13:47:24+02:00;Malakoff
Quai de la Seine;24;19;3;3;0;2023-04-06T13:44:52+02:00;Paris
Rossini - Laffitte;33;5;27;16;11;2023-04-06T13:47:59+02:00;Paris
Lisbonne - Monceau;33;20;13;7;6;2023-04-06T13:48:44+02:00;Paris
Argenteuil - Voltaire;16;13;3;2;1;2023-04-06T13:47:36+02:00;Asnières-sur-Seine
Gare de Lyon - Place Louis Armand;60;2;58;35;23;2023-04-06T13:48:59+02:00;Paris
Ranelagh - Mozart;23;10;12;3;9;2023-04-06T13:41:31+02:00;Paris
Chartres - La Charbonnière;34;31;2;1;1;2023-04-06T13:47:48+02:00;Paris
Place de Rhin et Danube;17;15;0;0;0;2023-04-06T13:48:58+02:00;Paris
Pesaro - Préfecture;22;2;20;6;14;2023-04-06T13:43:18+02:00;Nanterre
Roquette - Thiéré;23;9;12;10;2;2023-04-06T13:46:52+02:00;Paris
Moncey - Blanche;17;14;2;1;1;2023-04-06T13:41:17+02:00;Paris
Exelmans - Versailles;49;44;1;1;0;2023-04-06T13:48:02+02:00;Paris
Gare du Nord - Hôpital Lariboisière;49;45;3;1;2;2023-04-06T13:43:41+02:00;Paris
Schoelcher - Raspail;50;49;0;0;0;2023-04-06T13:48:43+02:00;Paris
Belidor - Gouvion-Saint-Cyr;39;38;0;0;0;2023-04-06T13:49:06+02:00;Paris
Claude Decaen - Cannebière;27;24;2;0;2;2023-04-06T13:47:23+02:00;Paris
Saint-Maur - Roquette;46;41;4;1;3;2023-04-06T13:48:17+02:00;Paris
Amelot - Saint-Sébastien;30;21;7;3;4;2023-04-06T13:48:16+02:00;Paris
11 Novembre 1918 - 8 Mai 1945;36;11;25;8;17;2023-04-06T13:48:27+02:00;Champigny-sur-Marne
Delphine Seyrig - Général Leclerc;53;45;8;5;3;2023-04-06T13:47:56+02:00;Pantin
Place Du Général De Gaulle;26;23;1;0;1;2023-04-06T13:45:22+02:00;Montreuil
Panthéon - Valette;39;4;33;5;28;2023-04-06T13:48:27+02:00;Paris
Pereire - Rennequin;23;21;2;2;0;2023-04-06T13:47:33+02:00;Paris
Pyrénées - Emmery;40;38;0;0;0;2023-04-06T13:48:17+02:00;Paris
Berri - Haussmann;35;10;24;8;16;2023-04-06T13:44:33+02:00;Paris
Gare RER - Canadiens;45;30;15;10;5;2023-04-06T13:44:05+02:00;Joinville-le-Pont
Cimetière de Montrouge;58;54;3;1;2;2023-04-06T13:47:52+02:00;Paris
Redoute - Les Courtilles;32;9;20;15;5;2023-04-06T13:48:27+02:00;Asnières-sur-Seine
Desaix - Edgar Faure;12;1;10;8;2;2023-04-06T13:47:36+02:00;Paris
Square Simon Bolivar;24;22;1;0;1;2023-04-06T13:42:03+02:00;Paris
Notre-Dame-des-Champs - Stanislas;19;0;18;15;3;2023-04-06T13:48:25+02:00;Paris
Richard Lenoir - Republique;58;51;2;2;0;2023-04-06T13:48:33+02:00;Paris
Saint-Ambroise - Parmentier;38;34;1;1;0;2023-04-06T13:46:39+02:00;Paris
Récollets - Square Villemin;17;15;2;0;2;2023-04-06T13:47:51+02:00;Paris
Pyramide - Ecole du Breuil;34;12;21;14;7;2023-04-06T13:47:47+02:00;Paris
Charles de Gaulle - Beauté;49;43;5;0;5;2023-04-06T13:47:53+02:00;Nogent-sur-Marne
Liège - Moscou;17;7;9;6;3;2023-04-06T13:48:50+02:00;Paris
Marne - Germain Dardan;22;18;4;4;0;2023-04-06T13:43:42+02:00;Montrouge
Mairie de Montreuil;52;41;7;2;5;2023-04-06T13:49:00+02:00;Montreuil
Mutualité;37;4;33;16;17;2023-04-06T13:49:05+02:00;Paris
Rouget de Lisle;35;3;30;26;4;2023-04-06T13:48:11+02:00;Choisy-le-Roi
Anatole France - President Roosevelt;29;10;19;13;6;2023-04-06T13:48:26+02:00;Aubervilliers
Cimetière de Montmartre;43;41;1;0;1;2023-04-06T13:45:37+02:00;Paris
Jourdain - Place des Grandes Rigoles;22;22;0;0;0;2023-04-06T13:48:43+02:00;Paris
Henry Farman;16;2;14;8;6;2023-04-06T13:45:28+02:00;Paris
Port-Royal - Hôpital du Val-de-Grâce;18;13;3;2;1;2023-04-06T13:48:05+02:00;Paris
Fontenay - Libération;25;18;6;4;2;2023-04-06T13:47:08+02:00;Vincennes
Grands Moulins de Pantin;50;38;11;4;7;2023-04-06T13:49:02+02:00;Paris
Gabriel Péri - Francisco Ferrer;18;16;1;0;1;2023-04-06T13:46:33+02:00;Le Pré-Saint-Gervais
Pajol - Place Herbert;39;36;2;0;2;2023-04-06T13:48:54+02:00;Paris
Concorde - Stalingrad;35;28;6;2;4;2023-04-06T13:48:07+02:00;Vitry-sur-Seine
Place de la Reine Astrid;58;4;51;31;20;2023-04-06T13:48:43+02:00;Paris
Carducci - Place Hannah Arendt;27;23;2;0;2;2023-04-06T13:48:28+02:00;Paris
Roger Salengro - Fontainebleau;25;22;3;0;3;2023-04-06T13:48:15+02:00;Le Kremlin-Bicêtre
Manin - Carrières d'Amérique;20;16;2;0;2;2023-04-06T13:47:09+02:00;Paris
Hôpital Européen Georges Pompidou;64;15;49;39;10;2023-04-06T13:47:49+02:00;Paris
Porte de Vanves;32;31;1;1;0;2023-04-06T13:43:07+02:00;Paris
Fédération - Suffren;25;24;1;1;0;2023-04-06T13:44:17+02:00;Paris
Victor Hugo - Jeanne Jugan;28;22;5;3;2;2023-04-06T13:40:39+02:00;Paris
Saint-Jacques - Val de Grâce;20;12;5;1;4;2023-04-06T13:48:57+02:00;Paris
Cimetière de Fontenay-sous-Bois;15;12;3;0;3;2023-04-06T13:48:55+02:00;Fontenay-sous-Bois
Conservatoire de Musique;25;6;19;12;7;2023-04-06T13:47:19+02:00;Choisy-le-Roi
Buisson Saint-Louis - Saint-Maur;19;18;0;0;0;2023-04-06T13:48:22+02:00;Paris
Lucie Aubrac - Fort;30;25;3;0;3;2023-04-06T13:48:28+02:00;Issy-les-Moulineaux
Place Albert Kahn;46;40;2;0;2;2023-04-06T13:48:13+02:00;Paris
Place Marcel Cachin;32;4;26;23;3;2023-04-06T13:47:16+02:00;Ivry-sur-Seine
Championnet - Vauvenargues;33;23;6;3;3;2023-04-06T13:48:09+02:00;Paris
Lecourbe - Jean Maridor;19;14;5;3;2;2023-04-06T13:49:07+02:00;Paris
Rocher - Laborde;65;35;29;13;16;2023-04-06T13:47:47+02:00;Paris
Mouton Duvernet - Général Leclerc;39;36;2;0;2;2023-04-06T13:49:02+02:00;Paris
Grenelle - Violet;35;6;28;26;2;2023-04-06T13:49:07+02:00;Paris
Marc Sangnier - Porte de Vanves;21;19;0;0;0;2023-04-06T13:46:29+02:00;Paris
Erasme - Ulm;24;8;15;3;12;2023-04-06T13:48:55+02:00;Paris
Etienne Jodelle - Saint Ouen;33;29;1;1;0;2023-04-06T13:44:25+02:00;Paris
Boissière - Etienne Dolet;21;19;1;0;1;2023-04-06T13:47:43+02:00;Montreuil
Guy Môquet - Etienne Dolet;23;21;1;0;1;2023-04-06T13:47:04+02:00;Malakoff
Sibelle - Alésia;25;24;0;0;0;2023-04-06T13:46:54+02:00;Paris
Jean Jaurès - Presles;30;20;6;2;4;2023-04-06T13:47:52+02:00;Pantin
Enghien - Faubourg Poissonnière;33;12;20;10;10;2023-04-06T13:46:20+02:00;Paris
Chabanais - Petits Champs;30;11;18;7;11;2023-04-06T13:45:21+02:00;Paris
David Weill - Parc Montsouris;22;18;3;0;3;2023-04-06T13:48:45+02:00;Paris
Bertie Albrecht - Hoche;32;19;11;6;5;2023-04-06T13:46:43+02:00;Paris
Saint Lambert - Blomet;27;21;4;2;2;2023-04-06T13:48:39+02:00;Paris
Cevennes - Bergers;29;21;8;6;2;2023-04-06T13:47:07+02:00;Paris
Place Robert Guillemard;24;4;19;16;3;2023-04-06T13:47:26+02:00;Paris
Molière - République;30;25;5;1;4;2023-04-06T13:45:39+02:00;Montrouge
Repos - Cimetière du Père Lachaise;33;31;0;0;0;2023-04-06T13:41:20+02:00;Paris
Marcadet - Barbès;37;33;2;0;2;2023-04-06T13:48:10+02:00;Paris
Edouard Tremblay - Julian Grimaux;30;28;2;0;2;2023-04-06T13:39:44+02:00;Vitry-sur-Seine
Hôtel de Ville de Boulogne Billancourt;26;2;19;17;2;2023-04-06T13:48:00+02:00;Boulogne-Billancourt
Gabriel Péri - Danielle Casanova;20;10;10;8;2;2023-04-06T13:48:40+02:00;Vitry-sur-Seine
Hoche - Jean Lolive;24;20;3;2;1;2023-04-06T13:48:11+02:00;Pantin
Tertres - Fontaine;28;24;4;1;3;2023-04-06T13:48:25+02:00;Bagneux
Marcelin Berthelot;27;11;15;13;2;2023-04-06T13:48:26+02:00;Boulogne-Billancourt
Place de la Porte de Champerret;0;0;0;0;0;2023-02-17T00:20:23+01:00;Paris
François Debergue - Croix de Chavaux;57;54;3;3;0;2023-04-06T13:46:18+02:00;Montreuil
Gare Rer de Fontenay sous Bois;61;55;4;1;3;2023-04-06T13:49:03+02:00;Fontenay-sous-Bois
Nationale - Place Jules Guesde;23;5;15;10;5;2023-04-06T13:48:06+02:00;Boulogne-Billancourt
Oberkampf - République;24;22;2;0;2;2023-04-06T13:44:17+02:00;Paris
Lakanal - Commerce;53;6;46;43;3;2023-04-06T13:49:05+02:00;Paris
Cossonnerie - Sébastopol;24;14;9;4;5;2023-04-06T13:46:25+02:00;Paris
Carnot - Pâquerettes;26;20;3;2;1;2023-04-06T13:47:06+02:00;Alfortville
Noisy le Sec - Jean-Baptiste Clément;22;21;0;0;0;2023-04-06T13:47:08+02:00;Bagnolet
Karl Marx;16;14;2;1;1;2023-04-06T13:44:00+02:00;Villejuif
Marcelle - Thalie;20;15;2;0;2;2023-04-06T13:40:11+02:00;Pantin
Raspail - Manufacture des Oeillets;32;13;19;16;3;2023-04-06T13:48:32+02:00;Ivry-sur-Seine
Louis Lumière - Porte de Bagnolet;20;17;2;0;2;2023-04-06T13:45:21+02:00;Paris
Cujas - Saint-Michel;19;11;4;3;1;2023-04-06T13:48:54+02:00;Paris
Jean Jaurès - Salvador Allende;43;43;0;0;0;2023-04-06T13:48:34+02:00;Malakoff
Henri Ste-Claire Déville - Paul Héroult;24;7;14;8;6;2023-04-06T13:42:09+02:00;Rueil-Malmaison
Victoire - Chaussée d'Antin;24;1;22;14;8;2023-04-06T13:44:30+02:00;Paris
Paris - Emile Zola;30;16;10;6;4;2023-04-06T13:48:22+02:00;Montreuil
Victor Hugo - Galliéni;34;7;26;19;7;2023-04-06T13:48:36+02:00;Boulogne-Billancourt
Quai Panhard et Levassor;57;9;46;36;10;2023-04-06T13:49:02+02:00;Paris
Richard Lenoir - Jean-Pierre Timbaud;36;32;2;1;1;2023-04-06T13:48:32+02:00;Paris
Chemin Vert - Saint-Maur;45;38;6;1;5;2023-04-06T13:43:39+02:00;Paris
Legendre - Dulong;23;19;2;0;2;2023-04-06T13:47:57+02:00;Paris
Botzaris - Parc des Buttes Chaumont;20;16;2;0;2;2023-04-06T13:46:42+02:00;Paris
Galilée - Kléber;32;22;10;2;8;2023-04-06T13:46:17+02:00;Paris
Général De Gaulle - Alouette;26;18;7;3;4;2023-04-06T13:41:24+02:00;Saint-Mandé
Square du Théâtre du Garde-Chasse;50;48;1;0;1;2023-04-06T13:46:27+02:00;Les Lilas
Rochechouart lamartine;24;16;7;7;0;2023-04-06T13:46:58+02:00;Paris
Estrapade - Ulm;16;4;11;1;10;2023-04-06T13:49:03+02:00;Paris
Joseph Liouville - Croix Nivert;64;60;4;2;2;2023-04-06T13:49:04+02:00;Paris
Hoche - Tilsitt;33;28;5;1;4;2023-04-06T13:48:46+02:00;Paris
Place Madeleine Daniélou;42;31;10;3;7;2023-04-06T13:48:39+02:00;Paris
Beffroy;26;2;24;15;9;2023-04-06T13:47:15+02:00;Neuilly-sur-Seine
Cauchy - Cévennes;51;8;40;39;1;2023-04-06T13:48:55+02:00;Paris
Molitor - Chardon-Lagache;34;4;28;23;5;2023-04-06T13:48:14+02:00;Paris
Jean-François Lépine - Stephenson;22;13;4;4;0;2023-04-06T13:48:18+02:00;Paris
Gare RER de Vincennes;51;31;19;17;2;2023-04-06T13:49:05+02:00;Vincennes
Abbé Carton - Plantes;25;23;1;0;1;2023-04-06T13:43:02+02:00;Paris
Mairie du 11ème;51;28;22;19;3;2023-04-06T13:49:01+02:00;Paris
Marie-Georges Picquart - Pereire;32;24;8;5;3;2023-04-06T13:49:06+02:00;Paris
Villette - Belleville;48;43;4;2;2;2023-04-06T13:48:17+02:00;Paris
Sablons - Georges Mandel;38;32;3;2;1;2023-04-06T13:47:07+02:00;Paris
Lieutenant Chauré - Etienne Marey;20;18;2;0;2;2023-04-06T13:48:17+02:00;Paris
Théophile Gautier - François Millet;30;5;22;18;4;2023-04-06T13:47:13+02:00;Paris
Parmentier - République;50;47;1;1;0;2023-04-06T13:44:42+02:00;Paris
Marché Secrétan;26;25;0;0;0;2023-04-06T13:49:02+02:00;Paris
Charles de Gaulle - Sablonville;26;16;9;3;6;2023-04-06T13:48:12+02:00;Neuilly-sur-Seine
Larmeroux - Baudelaire;29;27;1;0;1;2023-04-06T13:49:06+02:00;Vanves
Auguste Cain - Jean Moulin;40;40;0;0;0;2023-04-06T13:45:37+02:00;Paris
Arche - Léonard de Vinci;28;22;5;4;1;2023-04-06T13:48:25+02:00;Courbevoie
Chemin Vert - Fraternité;20;19;1;0;1;2023-04-06T13:45:23+02:00;Romainville
Miromesnil - La Boétie;35;12;22;8;14;2023-04-06T13:48:41+02:00;Paris
Parc Georges Brassens - Brancion;29;29;0;0;0;2023-04-06T13:45:46+02:00;Paris
Marseille - Beaurepaire;55;47;4;4;0;2023-04-06T13:47:48+02:00;Paris
Place Paul Eluard;19;0;19;17;2;2023-04-06T13:45:21+02:00;Choisy-le-Roi
Saint-Germain - Thenard;31;31;0;0;0;2023-04-06T13:46:33+02:00;Paris
Exelmans - Michel-Ange;33;26;6;4;2;2023-04-06T13:49:04+02:00;Paris
Arago - Glacière;27;26;1;0;1;2023-04-06T13:47:52+02:00;Paris
Pierret - Madrid;28;2;25;18;7;2023-04-06T13:48:00+02:00;Neuilly-sur-Seine
Parmentier - Abel Rabaud;52;44;3;0;3;2023-04-06T13:45:21+02:00;Paris
Aristide Briand - Gare de Bagneux;22;17;5;3;2;2023-04-06T13:48:35+02:00;Cachan
Mairie d'Ivry-sur-Seine;53;8;45;44;1;2023-04-06T13:48:41+02:00;Ivry-sur-Seine
Victoria - Place du Chatelet;22;13;5;2;3;2023-04-06T13:46:09+02:00;Paris
Reims - Raymond Pitet;37;33;2;0;2;2023-04-06T13:46:18+02:00;Paris
Seine - Flandre;19;17;2;0;2;2023-04-06T13:44:23+02:00;Paris
Saint-Vincent - Verdun;34;24;9;8;1;2023-04-06T13:49:00+02:00;Issy-les-Moulineaux
Hautpoul - Jean Jaurès;32;28;1;0;1;2023-04-06T13:47:55+02:00;Paris
Mathurins - Auber;36;7;27;16;11;2023-04-06T13:48:54+02:00;Paris
Grand Prieuré - Crussol;49;18;28;27;1;2023-04-06T13:47:50+02:00;Paris
Wilson - Métallurgie;28;17;9;2;7;2023-04-06T13:46:37+02:00;Saint-Denis
Square d'Anvers;33;31;1;0;1;2023-04-06T13:48:56+02:00;Paris
Madame de Sanzillon - Mozart;22;12;6;5;1;2023-04-06T13:48:13+02:00;Clichy
Mairie du 7ème;27;1;24;6;18;2023-04-06T13:48:07+02:00;Paris
Quai du docteur Dervaux;26;26;0;0;0;2023-01-18T09:46:16+01:00;Asnières-sur-Seine
Volontaire - Lecourbe;31;11;20;18;2;2023-04-06T13:47:13+02:00;Paris
Gare Arcueil - Cachan;26;13;13;3;10;2023-04-06T13:48:31+02:00;Arcueil
Laumière - Petit;34;30;1;0;1;2023-04-06T13:48:38+02:00;Paris
Gare RER de Gentilly;30;28;1;0;1;2023-04-06T13:47:58+02:00;Gentilly
Marignan - Champs-Elysées;35;21;13;4;9;2023-04-06T13:47:59+02:00;Paris
Place Jean Ferrat;25;17;6;3;3;2023-04-06T13:49:03+02:00;Ivry-sur-Seine
Villiers de l'Isle Adam - Pyrénées;20;18;1;0;1;2023-04-06T13:47:16+02:00;Paris
Stalingrad - Désiré Chevalier;42;40;1;0;1;2023-04-06T13:47:21+02:00;Montreuil
Place de la Porte de Paris;40;35;3;2;1;2023-04-06T13:47:09+02:00;Saint-Denis
Saint-Jacques - Soufflot;0;0;0;0;0;2018-06-06T08:42:14+02:00;Paris
Place Amédée Gordini - Lefebvre;38;25;13;5;8;2023-04-06T13:48:29+02:00;Paris
Flandre - Alphonse Karr;25;18;5;5;0;2023-04-06T13:47:39+02:00;Paris
Hôpital Bégin;26;0;25;18;7;2023-04-06T13:47:48+02:00;Vincennes
Hôtel de Ville de Nanterre;38;11;26;2;24;2023-04-06T13:48:52+02:00;Nanterre
Charonne - Faubourg Saint-Antoine;34;0;34;29;5;2023-04-06T13:48:50+02:00;Paris
Victor Hugo - Ecoles;25;8;17;15;2;2023-04-06T13:48:00+02:00;Alfortville
Jules Ferry - Faubourg du Temple Paris;58;50;7;5;2;2023-04-06T13:48:02+02:00;Paris
Tristan Tzara -  Tchaïkovski;33;23;7;6;1;2023-04-06T13:46:35+02:00;Paris
Stephenson - Doudeauville;36;30;2;1;1;2023-04-06T13:48:11+02:00;Paris
Raspail - Bac;52;52;0;0;0;2023-04-06T13:44:49+02:00;Paris
Charenton - Diderot;18;15;2;1;1;2023-04-06T13:49:00+02:00;Paris
Montgallet - Charenton;16;4;9;8;1;2023-04-06T13:47:46+02:00;Paris
Place de l'Édit de Nantes;30;27;2;0;2;2023-04-06T13:48:04+02:00;Paris
Gaston Roussel - Commune de Paris;30;19;10;1;9;2023-04-06T13:42:27+02:00;Romainville
Boulard - Daguerre;45;44;1;0;1;2023-04-06T13:42:52+02:00;Paris
Porte de Vincennes;33;19;14;10;4;2023-04-06T13:45:49+02:00;Paris
Boyer - Ménilmontant;19;1;2;0;2;2023-03-13T01:29:37+01:00;Paris
Bienfaisance - Place de Narvik;36;12;23;7;16;2023-04-06T13:47:17+02:00;Paris
Saint Georges - d'Aumale;23;21;2;0;2;2023-04-06T13:42:01+02:00;Paris
Square Gilbert Thomain;20;19;1;0;1;2023-04-06T13:45:53+02:00;Asnières-sur-Seine
Anatole France - Louise Michel;50;33;15;13;2;2023-04-06T13:47:03+02:00;Levallois-Perret
Alfred Roll - Berthier;28;25;3;1;2;2023-04-06T13:43:05+02:00;Paris
Stalingrad - Germaine Tailleferre;28;24;4;1;3;2023-04-06T13:47:01+02:00;Ivry-sur-Seine
Varenne;47;47;0;0;0;2023-04-06T13:46:17+02:00;Paris
Guynemer - Séverine;26;0;25;21;4;2023-04-06T13:45:36+02:00;Issy-les-Moulineaux
Flandre - Riquet;21;17;4;2;2;2023-04-06T13:42:34+02:00;Paris
Jacques Callot - Mazarine;28;3;24;14;10;2023-04-06T13:47:18+02:00;Paris
Jean Macé - Faidherbe;63;35;27;25;2;2023-04-06T13:48:45+02:00;Paris
Richard Wallace - Place du 8 Mai 1945;30;19;10;6;4;2023-04-06T13:48:40+02:00;Puteaux
Ancien Canal - Hélène Brion;23;19;4;1;3;2023-04-06T13:40:31+02:00;Pantin
Faustin Hélie - Desbordes-Valmore;33;27;2;0;2;2023-04-06T13:48:17+02:00;Paris
Boulets - Voltaire;24;21;2;2;0;2023-04-06T13:47:07+02:00;Paris
Dupleix - du Guesclin;47;26;21;16;5;2023-04-06T13:48:17+02:00;Paris
Pasteur - Gambetta;19;2;17;9;8;2023-04-06T13:48:31+02:00;Saint-Mandé
Departement - Pajol;19;17;1;0;1;2023-04-06T13:44:36+02:00;Paris
Place des Ternes.;46;44;2;2;0;2023-04-06T13:48:56+02:00;Paris
Fragonard - Porte de Clichy;56;4;47;46;1;2023-04-06T13:47:27+02:00;Paris
Montgallet - Reuilly;16;8;7;5;2;2023-04-06T13:47:06+02:00;Paris
Place de Verdun;40;6;34;33;1;2023-04-06T13:46:18+02:00;Joinville-le-Pont
Montreuil - Gonnet;24;17;5;2;3;2023-04-06T13:48:55+02:00;Paris
Edouard Poisson - Victor Hugo;30;10;19;15;4;2023-04-06T13:45:01+02:00;Aubervilliers
Commandant Rivière;27;1;23;9;14;2023-04-06T13:48:52+02:00;Paris
Parmentier - Hôpital Saint-Louis;43;40;1;0;1;2023-04-06T13:44:41+02:00;Paris
Square Cambronne;59;59;0;0;0;2023-03-27T23:08:50+02:00;Paris
Place Jacques Madaule;25;8;17;17;0;2023-04-06T13:47:19+02:00;Issy-les-Moulineaux
Porte Maillot - Pereire;0;0;0;0;0;2022-07-25T00:02:50+02:00;Paris
Place de la Porte de Châtillon;59;50;7;5;2;2023-04-06T13:48:40+02:00;Paris
Clignancourt - Sofia;19;16;1;0;1;2023-04-06T13:45:10+02:00;Paris
Jussieu - Fossés Saint-Bernard;39;0;38;34;4;2023-04-06T13:48:41+02:00;Paris
Quai de la Loire - Jean Jaurès;16;12;1;1;0;2023-04-06T13:48:50+02:00;Paris
Jardin d'Acclimatation;33;19;13;3;10;2023-04-06T13:47:33+02:00;Paris
Route de Sèvres - Porte de Bagatelle;66;11;51;49;2;2023-04-06T13:48:54+02:00;Paris
Gare Montparnasse - René Mouchotte;39;29;10;9;1;2023-04-06T13:49:08+02:00;Paris
Assemblée Nationale;63;63;0;0;0;2023-04-06T13:47:56+02:00;Paris
Paul Vaillant Couturier - Chaptal;39;8;29;4;25;2023-04-06T13:49:03+02:00;Levallois-Perret
Bordier - Félix Faure;48;37;8;6;2;2023-04-06T13:44:41+02:00;Aubervilliers
Gare de Laplace;43;37;6;4;2;2023-04-06T13:41:28+02:00;Arcueil
Charonne - Avron;27;24;2;0;2;2023-04-06T13:43:11+02:00;Paris
Bayen - Pereire;22;11;9;4;5;2023-04-06T13:45:06+02:00;Paris
Félix Faure - Sadi Carnot;33;11;18;12;6;2023-04-06T13:48:59+02:00;Aubervilliers
Alexandre Dumas - Voltaire;59;34;18;15;3;2023-04-06T13:41:01+02:00;Paris
Mairie de La Garenne Colombes;22;13;6;4;2;2023-04-06T13:48:29+02:00;La Garenne-Colombes
18 juin 1940 - Buzenval;25;21;3;2;1;2023-04-06T13:45:37+02:00;Rueil-Malmaison
Jean Colly - Tolbiac;36;26;8;2;6;2023-04-06T13:49:07+02:00;Paris
Gare de Courbevoie;35;30;3;3;0;2023-04-06T13:46:50+02:00;Courbevoie
Porte de la Villette;27;12;12;9;3;2023-04-06T13:47:20+02:00;Paris
Dugommier;55;47;6;4;2;2023-04-06T13:48:17+02:00;Paris
Ouest - Château;23;23;0;0;0;2023-04-06T13:45:40+02:00;Paris
Victor Hugo - Magasins Généraux;34;4;29;16;13;2023-04-06T13:47:47+02:00;Aubervilliers
Place aux Étoiles;40;23;17;6;11;2023-04-06T13:46:37+02:00;Saint-Denis
Réunion - Avron;26;23;3;3;0;2023-04-06T13:48:35+02:00;Paris
Flandrin - Henri Martin;18;14;4;2;2;2023-04-06T13:48:20+02:00;Paris
Square des Saint-Simoniens;25;24;0;0;0;2023-04-06T13:47:23+02:00;Paris
Pirogues de Bercy - Libourne;49;28;20;9;11;2023-04-06T13:49:07+02:00;Paris
Gare d'Austerlitz;14;2;10;7;3;2023-04-06T13:43:05+02:00;Paris
Place Violet;30;16;13;11;2;2023-04-06T13:44:31+02:00;Paris
Ménilmontant - Pelleport;19;16;3;0;3;2023-04-06T13:48:08+02:00;Paris
Porte d'Auteuil;33;17;14;7;7;2023-04-06T13:44:40+02:00;Paris
Jussieu - Guy de la Brosse;40;0;40;26;14;2023-04-06T13:48:39+02:00;Paris
Place Jean-Baptiste Clément;25;21;2;0;2;2023-04-06T13:46:34+02:00;Le Kremlin-Bicêtre
Champeaux - Gallieni;50;49;0;0;0;2023-04-06T13:46:23+02:00;Bagnolet
Claude Bernard - Arbalète;17;15;2;0;2;2023-04-06T13:41:08+02:00;Paris
Courcelles - Place des Ternes;31;25;2;1;1;2023-04-06T13:48:57+02:00;Paris
Petit - Manin;22;19;3;1;2;2023-04-06T13:39:49+02:00;Paris
Parvis Robert Schuman - Roger Salengro;24;24;0;0;0;2023-04-06T13:40:14+02:00;Chaville
Gare de Clamart;14;13;0;0;0;2023-04-06T13:43:47+02:00;Clamart
Place Carnot;25;22;1;1;0;2023-04-06T13:40:20+02:00;Montreuil
Place des Marseillais;37;27;8;6;2;2023-04-06T13:46:51+02:00;Charenton-le-Pont
Gare de Bercy;35;12;21;14;7;2023-04-06T13:49:06+02:00;Paris
Charenton - Wattignies;33;29;4;4;0;2023-04-06T13:46:59+02:00;Paris
Ceinture du Lac Inferieure - Saint-Cloud;42;38;3;1;2;2023-04-06T13:47:25+02:00;Paris
Chanzy - Sud-Est;25;5;20;16;4;2023-04-06T13:48:46+02:00;Nanterre
Anatole France - Jean Lolive;28;18;8;3;5;2023-04-06T13:48:11+02:00;Pantin
Jean Lolive - Parc Stalingrad;22;20;2;0;2;2023-04-06T13:42:54+02:00;Pantin
Boyer-Barret - Raymond Losserand;23;21;2;0;2;2023-04-06T13:47:37+02:00;Paris
Parc Pierre Lagravère;30;5;23;14;9;2023-04-06T13:47:43+02:00;Colombes
Lagny - Joffre;31;7;23;14;9;2023-04-06T13:46:41+02:00;Saint-Mandé
Guichet - Jean Jaurès;28;23;4;1;3;2023-04-06T13:42:01+02:00;Clichy
Place Falguière;23;20;2;0;2;2023-04-06T13:46:48+02:00;Paris
Evariste Galois;30;27;1;0;1;2023-04-06T13:46:15+02:00;Paris
Parc Monceau;18;10;8;3;5;2023-04-06T13:47:31+02:00;Paris
Navier - Epinettes;36;33;3;0;3;2023-04-06T13:43:22+02:00;Paris
Tardieu - Chappe;18;15;1;0;1;2023-04-06T13:48:37+02:00;Paris
Verdun - Place Henri IV;26;11;14;8;6;2023-04-06T13:49:02+02:00;Suresnes
Gare d'Austerlitz - Quai Saint-Bernard;27;27;0;0;0;2022-01-18T22:07:57+01:00;Paris
Edgar Quinet - Gaité;27;24;3;2;1;2023-04-06T13:44:08+02:00;Paris
Nanterre - Université;20;1;19;9;10;2023-04-06T13:48:30+02:00;Nanterre
Gravelle - Route du Bac;51;46;5;2;3;2023-04-06T13:47:16+02:00;Paris
Francoeur - Marcadet;20;18;2;1;1;2023-04-06T13:44:58+02:00;Paris
Piat - Parc de Belleville;21;20;0;0;0;2023-04-06T13:47:47+02:00;Paris
Pascal - Claude Bernard;49;28;17;16;1;2023-04-06T13:46:42+02:00;Paris
Emeriau - Place de Brazzaville;51;4;47;43;4;2023-04-06T13:47:29+02:00;Paris
Lamennais - Washington;26;1;21;11;10;2023-04-06T13:48:05+02:00;Paris
Petites Ecuries - Faubourg Poissonnière;17;4;12;3;9;2023-04-06T13:47:06+02:00;Paris
Batignolles - Place de Clichy;47;43;1;1;0;2023-04-06T13:48:49+02:00;Paris
Place Valhubert;37;37;0;0;0;2023-04-06T13:42:29+02:00;Paris
Londres - Amsterdam;0;0;0;0;0;2023-01-09T05:28:33+01:00;Paris
Henri Chevreau - Couronnes;27;24;0;0;0;2023-04-06T13:47:56+02:00;Paris
Vladimir Ilitch Lénine - Andrée Chedid;31;30;0;0;0;2023-04-06T13:42:11+02:00;Gentilly
Vignerons - Minimes;29;24;5;3;2;2023-04-06T13:45:05+02:00;Vincennes
Bineau - Louise Michel;25;17;6;4;2;2023-04-06T13:47:55+02:00;Levallois-Perret
Sommerard - Saint-Jacques;34;4;24;9;15;2023-04-06T13:48:48+02:00;Paris
Quai Voltaire;32;1;29;21;8;2023-04-06T13:48:36+02:00;Paris
Grenelle - Dr Finlay;71;7;59;55;4;2023-04-06T13:48:24+02:00;Paris
Uzès - Montmartre;29;10;17;15;2;2023-04-06T13:48:45+02:00;Paris
Porte d'Orléans;48;42;4;1;3;2023-04-06T13:48:40+02:00;Paris
Ledru-Rollin - Charonne;32;3;28;22;6;2023-04-06T13:47:32+02:00;Paris
Pierre et Marie Curie - Julien Grimau;18;15;1;0;1;2023-04-06T13:48:34+02:00;Bagnolet
Parc de Belleville - Julien Lacroix;26;25;1;0;1;2023-04-06T13:44:32+02:00;Paris
Pierre Grenier - Pont de Billancourt;21;18;2;2;0;2023-04-06T13:44:16+02:00;Boulogne-Billancourt
Gare de Pont-Cardinet;34;30;3;1;2;2023-04-06T13:46:09+02:00;Paris
Professeur René Leriche - Général Leclerc;50;37;11;8;3;2023-04-06T13:47:02+02:00;Clichy
Saint-François-Xavier;42;41;1;1;0;2023-04-06T13:48:53+02:00;Paris
Morice - Général Leclerc;25;19;2;1;1;2023-04-06T13:49:04+02:00;Clichy
Pierre Larousse - Raymond Losserand;30;22;7;2;5;2023-04-06T13:47:11+02:00;Paris
Capitaine Glarner - Gabriel Péri;27;9;18;15;3;2023-04-06T13:48:26+02:00;Saint-Ouen-sur-Seine
Pitié-Salpêtrière;51;30;21;6;15;2023-04-06T13:48:52+02:00;Paris
Place Jean Delay;35;35;0;0;0;2023-04-06T13:49:06+02:00;Paris
Vasco de Gama;54;12;41;40;1;2023-04-06T13:47:08+02:00;Paris
Pont de Levallois-bécon;50;9;38;22;16;2023-04-06T13:47:59+02:00;Levallois-Perret
Jonquoy - Didot;30;30;0;0;0;2023-04-06T13:49:05+02:00;Paris
Charles Delescluze;49;25;19;18;1;2023-04-06T13:47:10+02:00;Paris
Lauriston - Copernic;19;13;6;0;6;2023-04-06T13:39:49+02:00;Paris
Lucien Sampaix - Récollets;46;37;6;5;1;2023-04-06T13:41:25+02:00;Paris
Gare de l'Est - Verdun;14;13;0;0;0;2023-04-06T13:49:03+02:00;Paris
Place du Général de Gaulle;28;19;9;3;6;2023-04-06T13:46:02+02:00;Fontenay-sous-Bois
Bara - Henri Farman;36;4;32;22;10;2023-04-06T13:48:42+02:00;Issy-les-Moulineaux
Charenton - Place du Col Bourgoin;35;30;3;2;1;2023-04-06T13:46:44+02:00;Paris
Edouard Vaillant - Paul-Adolphe Souriau;28;14;13;6;7;2023-04-06T13:44:57+02:00;Boulogne-Billancourt
Haxo - Surmelin;21;19;0;0;0;2023-04-06T13:43:20+02:00;Paris
Michelet - Assas;18;5;12;4;8;2023-04-06T13:48:18+02:00;Paris
Place Alphonse Deville;23;5;15;9;6;2023-04-06T13:48:52+02:00;Paris
Porte Dorée;36;31;5;1;4;2023-04-06T13:48:16+02:00;Paris
Place Adolphe Cherioux - Vaugirard;63;59;4;1;3;2023-04-06T13:46:56+02:00;Paris
Belleville - Porte des Lilas;32;29;3;0;3;2023-04-06T13:41:55+02:00;Paris
Tanger - Place du Maroc;19;17;0;0;0;2023-04-06T13:48:46+02:00;Paris
Mézières - Rennes;55;46;9;4;5;2023-04-06T13:48:33+02:00;Paris
Place du Cornillon - Stade de France;35;29;6;2;4;2023-04-06T13:42:04+02:00;Saint-Denis
Sèvres-Gallieni;27;10;14;11;3;2023-04-06T13:48:50+02:00;Boulogne-Billancourt
Place du Maréchal Juin - Péreire;46;40;3;2;1;2023-04-06T13:47:10+02:00;Paris
Vincennes - Douy-Delcupe;38;35;0;0;0;2023-04-06T13:48:34+02:00;Montreuil
Lucie Aubrac - Franklin;36;34;1;0;1;2023-04-06T13:49:05+02:00;Montreuil
Porte de Clignancourt.;56;52;3;0;3;2023-04-06T13:43:18+02:00;Paris
Hôtel de Ville d'Argenteuil;30;21;9;6;3;2023-04-06T13:48:19+02:00;Argenteuil
Porte de Saint-Ouen - Henri Huchard;26;19;7;5;2;2023-04-06T13:47:10+02:00;Paris
Gare Routière de Saint Cloud;31;4;26;23;3;2023-04-06T13:48:10+02:00;Saint-Cloud
Génie - Mozart;19;15;4;3;1;2023-04-06T13:43:02+02:00;Vitry-sur-Seine
Primo Levi - Frigos;34;1;33;21;12;2023-04-06T13:46:02+02:00;Paris
Gare de l'Est - Place du 11 Novembre 1918;40;32;6;1;5;2023-04-06T13:48:27+02:00;Paris
Dunois - Clisson;51;46;5;0;5;2023-04-06T13:47:03+02:00;Paris
Belfort - Voltaire;39;21;16;14;2;2023-04-06T13:44:47+02:00;Paris
Jean Jaurès - Jean Baptiste Clément;24;10;13;12;1;2023-04-06T13:48:24+02:00;Boulogne-Billancourt
Batignolles - Rome;15;13;2;0;2;2023-04-06T13:47:53+02:00;Paris
Mairie du 18ème;40;30;7;4;3;2023-04-06T13:47:16+02:00;Paris
Place Charles Vallin;26;23;2;0;2;2023-04-06T13:48:52+02:00;Paris
Bridaine - Lamandé;29;28;0;0;0;2023-04-06T13:47:20+02:00;Paris
Colonel Monteil - Brune;19;18;1;0;1;2023-04-06T13:47:51+02:00;Paris
Laffitte - Italiens;33;4;29;15;14;2023-04-06T13:46:51+02:00;Paris
Verdun - Adrien Damalix;26;19;5;1;4;2023-04-06T13:48:15+02:00;Saint-Maurice
Indre - Prairies;38;36;2;0;2;2023-04-06T13:47:01+02:00;Paris
Milton - Manuel;22;21;1;0;1;2023-04-06T13:48:33+02:00;Paris
Paris - Désiré Préaux;49;38;8;1;7;2023-04-06T13:49:03+02:00;Montreuil
Mahatma Gandhi;26;14;12;7;5;2023-04-06T13:47:47+02:00;Paris
Lourmel - Marie Skobtsov;22;12;10;8;2;2023-04-06T13:47:57+02:00;Paris
Edouard Pailleron - Simon Bolivar;24;20;0;0;0;2023-04-06T13:43:47+02:00;Paris
Belleville - Télégraphe;41;38;1;0;1;2023-04-06T13:44:14+02:00;Paris
Eglise d'Auteuil;21;3;12;5;7;2023-04-06T13:47:55+02:00;Paris
Gare d'Asnières sur Seine;24;13;7;6;1;2023-04-06T13:47:26+02:00;Asnières-sur-Seine
Château - Bineau;23;22;0;0;0;2023-04-06T13:44:05+02:00;Neuilly-sur-Seine
République - Danton;20;15;4;0;4;2023-04-06T13:48:43+02:00;Fontenay-sous-Bois
Porte de Ménilmontant;15;14;1;1;0;2023-04-06T13:44:15+02:00;Paris
Mac-Mahon - Brey;25;15;10;1;9;2023-04-06T13:45:28+02:00;Paris
Courcelles - Pierre Demours;26;24;1;1;0;2023-04-06T13:48:20+02:00;Paris
Les Planètes;16;9;7;5;2;2023-04-06T13:48:20+02:00;Maisons-Alfort
Danton - Serpente;22;10;12;6;6;2023-04-06T13:45:32+02:00;Paris
Lepic - Armée d'Orient;24;20;1;0;1;2023-04-06T13:48:51+02:00;Paris
Université Paris Dauphine;0;0;0;0;0;2018-03-09T08:53:33+01:00;Paris
Lassus - Delouvain;20;20;0;0;0;2023-04-06T13:49:06+02:00;Paris
Square des Epinettes;20;17;1;0;1;2023-04-06T13:42:50+02:00;Paris
Square du Carrefour de l'Insurrection;23;21;0;0;0;2023-04-06T13:47:47+02:00;Vanves
Chabrol - d'Hauteville;11;4;7;1;6;2023-04-06T13:45:54+02:00;Paris
Provence - Chaussée d'Antin;25;4;19;15;4;2023-04-06T13:46:40+02:00;Paris
Cité des Sciences et de l'Industrie;30;18;12;11;1;2023-04-06T13:46:12+02:00;Paris
Pelleport - Belgrand;15;13;0;0;0;2023-04-06T13:45:00+02:00;Paris
Pajol - Riquet;47;39;3;1;2;2023-04-06T13:48:56+02:00;Paris
Assas - Vaugirard;35;0;34;19;15;2023-04-06T13:48:51+02:00;Paris
Emile Blemont - Poteau;39;33;1;0;1;2023-04-06T13:46:47+02:00;Paris
Place Etienne Pernet;43;16;26;21;5;2023-04-06T13:47:36+02:00;Paris
Toffier Decaux - Cartier Bresson;18;16;1;0;1;2023-04-06T13:48:03+02:00;Pantin
Porte d'Aubervilliers;55;38;12;9;3;2023-04-06T13:46:51+02:00;Paris
Orteaux - Mouraud;24;20;0;0;0;2023-04-06T13:49:03+02:00;Paris
Sadi Carnot - François Mitterrand;27;27;0;0;0;2023-04-06T13:40:39+02:00;Bagnolet
François Ponsard - La Muette;23;22;1;0;1;2023-04-06T13:48:13+02:00;Paris
Gabrielle Josserand - Edouard Vaillant;25;20;3;2;1;2023-04-06T13:46:29+02:00;Pantin
Bellefond - Maubeuge;31;22;8;2;6;2023-04-06T13:46:02+02:00;Paris
Théâtre - Lourmel;53;9;44;40;4;2023-04-06T13:47:50+02:00;Paris
Square Saint-Ambroise;43;4;36;35;1;2023-04-06T13:49:06+02:00;Paris
Charles de Gaulle - Jean Lolive;26;25;1;0;1;2023-04-06T13:46:53+02:00;Pantin
Hameau Fleuri - Marché;22;5;16;10;6;2023-04-06T13:48:52+02:00;Boulogne-Billancourt
Daumesnil - Picpus;21;5;16;15;1;2023-04-06T13:44:35+02:00;Paris
Ecole Vétérinaire;36;24;10;8;2;2023-04-06T13:48:02+02:00;Maisons-Alfort
Place Pasdeloup;21;9;10;8;2;2023-04-06T13:47:06+02:00;Paris
Ledru-Rollin - Place du Père Chaillet;37;19;18;16;2;2023-04-06T13:48:47+02:00;Paris
Diderot - Pierre Bourdan;21;12;8;7;1;2023-04-06T13:43:47+02:00;Paris
Aubervilliers - Curial;23;18;3;2;1;2023-04-06T13:47:28+02:00;Paris
Jean-Baptiste Pigalle - La Bruyere;17;12;2;1;1;2023-04-06T13:43:41+02:00;Paris
Bassano -  Iéna;15;5;9;2;7;2023-04-06T13:47:02+02:00;Paris
Transvaal - Charles de Gaulle;27;8;16;12;4;2023-04-06T13:47:44+02:00;Boulogne-Billancourt
Balard - Montagne de la Fage;36;16;20;17;3;2023-04-06T13:46:53+02:00;Paris
Boulets - Faubourg Saint-Antoine;43;36;7;6;1;2023-04-06T13:47:35+02:00;Paris
Méchain - Faubourg Saint-Jacques;16;13;3;3;0;2023-04-06T13:48:21+02:00;Paris
Haies - Réunion;22;20;0;0;0;2023-04-06T13:48:56+02:00;Paris
Stade Auguste Delaune;21;12;9;5;4;2023-04-06T13:47:33+02:00;Maisons-Alfort
Pyrénées - Maraîchers;19;15;1;0;1;2023-04-06T13:46:09+02:00;Paris
Belliard - Damrémont;34;28;4;1;3;2023-04-06T13:45:29+02:00;Paris
Place Jacques Bonsergent;33;21;11;7;4;2023-04-06T13:48:14+02:00;Paris
Route de la Muette - Porte de Neuilly;50;25;20;13;7;2023-04-06T13:48:32+02:00;Paris
Square René Viviani - Montebello;34;18;13;8;5;2023-04-06T13:46:05+02:00;Paris
Maine - Antoine Bourdelle;17;12;5;5;0;2023-04-06T13:48:31+02:00;Paris
Place de Passy;15;12;3;1;2;2023-04-06T13:48:16+02:00;Paris
Kléber - Gouverneur Général Eboué;24;6;13;11;2;2023-04-06T13:46:34+02:00;Issy-les-Moulineaux
Pont Neuf - Rivoli;27;1;25;21;4;2023-04-06T13:48:14+02:00;Paris
Président Wilson - Jean Jaures;27;21;4;0;4;2023-04-06T13:43:06+02:00;Levallois-Perret
Lavandieres Sainte Opportune - Rivoli;27;20;6;5;1;2023-04-06T13:48:59+02:00;Paris
Gare RER de Saint-Denis;40;18;20;5;15;2023-04-06T13:48:43+02:00;Saint-Denis
Caulaincourt - Place Constantin Pecqueur;44;36;6;0;6;2023-04-06T13:49:04+02:00;Paris
Mozart - Jasmin;62;58;2;1;1;2023-04-06T13:44:46+02:00;Paris
Lallier - Trudaine;29;22;5;2;3;2023-04-06T13:48:18+02:00;Paris
Clichy - Place Blanche;20;16;2;0;2;2023-04-06T13:45:14+02:00;Paris
Diderot - Reuilly;44;35;6;6;0;2023-04-06T13:48:07+02:00;Paris
Wilson - Landy;40;14;24;19;5;2023-04-06T13:47:11+02:00;Saint-Denis
Fontainebleau - Edmond Michelet;45;43;2;0;2;2023-04-06T13:47:50+02:00;Le Kremlin-Bicêtre
Maison de Radio - France;47;13;28;23;5;2023-04-06T13:48:55+02:00;Paris
Pernety - Raymond Losserand;32;30;2;0;2;2023-04-06T13:48:51+02:00;Paris
Naples - Rome;26;22;4;2;2;2023-04-06T13:46:55+02:00;Paris
Hôpital Pitié Salpêtrière;50;32;18;11;7;2023-04-06T13:48:41+02:00;Paris
Square Léon;33;30;2;0;2;2023-04-06T13:47:54+02:00;Paris
Gare Montparnasse - Vaugirard;66;18;48;12;36;2023-04-06T13:46:42+02:00;Paris
Chernoviz - Raynouard;37;31;3;0;3;2023-04-06T13:48:59+02:00;Paris
Champ de Mars - Cler;41;24;15;11;4;2023-04-06T13:48:51+02:00;Paris
Eugène Reisz - Davout;20;17;0;0;0;2023-04-06T13:49:04+02:00;Paris
Sénat - Condé;33;3;10;4;6;2023-04-06T13:47:48+02:00;Paris
Eugène Oudiné - Dessous Des Berges;44;34;10;3;7;2023-04-06T13:45:52+02:00;Paris
Granges aux Belles - Hôpital Saint-Louis;60;58;2;1;1;2023-04-06T13:45:17+02:00;Paris
Mont Valérien - Michel Salles;24;22;0;0;0;2023-04-06T13:43:52+02:00;Saint-Cloud
Belleville - Pyrénées;42;37;2;0;2;2023-04-06T13:47:49+02:00;Paris
Traversière - Ledru-Rollin;34;3;28;26;2;2023-04-06T13:48:34+02:00;Paris
Parc de Choisy;25;23;2;1;1;2023-04-06T13:49:00+02:00;Paris
Neuve Saint-Pierre - Beautreillis;20;16;2;2;0;2023-04-06T13:48:07+02:00;Paris
Gustave Eiffel - Parc des Impressionnistes;30;17;11;9;2;2023-04-06T13:46:11+02:00;Clichy
Sabot - Rennes;26;1;24;18;6;2023-04-06T13:46:24+02:00;Paris
Borrégo - Gambetta;25;23;1;0;1;2023-04-06T13:48:38+02:00;Paris
Pereire - Place de Wagram;46;41;4;0;4;2023-04-06T13:44:46+02:00;Paris
Aqueduc - Villette;28;22;3;2;1;2023-04-06T13:48:10+02:00;Paris
Palais des Sports;22;3;17;16;1;2023-04-06T13:47:14+02:00;Paris
Manin - Simon Bolivar;26;24;0;0;0;2023-04-06T13:44:02+02:00;Paris
Villersexel - Saint-Germain;16;16;0;0;0;2023-04-06T13:41:19+02:00;Paris
Calmette;32;29;0;0;0;2023-04-06T13:45:53+02:00;Les Lilas
Jeanne Hornet - Girardot;29;25;2;0;2;2023-04-06T13:47:11+02:00;Bagnolet
Duroc - Place de Breteuil;42;14;28;20;8;2023-04-06T13:47:03+02:00;Paris
Billancourt - Général Leclerc;22;17;3;2;1;2023-04-06T13:48:27+02:00;Boulogne-Billancourt
Bois de Vincennes.;60;55;4;2;2;2023-04-06T13:47:18+02:00;Saint-Mandé
Favart - Italiens;17;1;15;8;7;2023-04-06T13:47:35+02:00;Paris
Parc André Citroën;65;9;51;47;4;2023-04-06T13:48:15+02:00;Paris
Parvis Corentin Celton;55;5;43;42;1;2023-04-06T13:49:08+02:00;Issy-les-Moulineaux
François 1er - Montaigne;29;3;26;13;13;2023-04-06T13:48:54+02:00;Paris
Vieille du Temple - Francs Bourgeois;29;17;9;3;6;2023-04-06T13:43:52+02:00;Paris
Saint-Jacques - Tombe Issoire;23;23;0;0;0;2023-04-06T13:42:05+02:00;Paris
Hôtel de Ville - Pont-Marie;36;17;19;18;1;2023-04-06T13:48:23+02:00;Paris
Surcouf - Université;58;11;43;32;11;2023-04-06T13:48:37+02:00;Paris
Hôtel de Ville de Champigny sur Marne;21;4;15;14;1;2023-04-06T13:47:19+02:00;Champigny-sur-Marne
Ney - Charles Hermite;20;5;15;13;2;2023-04-06T13:45:54+02:00;Paris
Porte d'Ivry;50;41;8;7;1;2023-04-06T13:48:19+02:00;Paris
Beaujon - Wagram;29;25;2;0;2;2023-04-06T13:44:09+02:00;Paris
Faubourg Poissonniere - Delta;36;35;1;1;0;2023-04-06T13:46:45+02:00;Paris
Raspail - Chomel;49;3;46;37;9;2023-04-06T13:48:54+02:00;Paris
Place François Mitterand;34;31;0;0;0;2023-04-06T13:47:36+02:00;Montreuil
Gare du Nord - Demarquay;30;29;0;0;0;2023-04-06T13:44:58+02:00;Paris
Greneta - Sebastopol;32;27;4;3;1;2023-04-06T13:48:55+02:00;Paris
Place Pigalle;21;19;1;1;0;2023-04-06T13:44:48+02:00;Paris
Poissonniers - Nord;28;26;2;1;1;2023-04-06T13:47:57+02:00;Paris
Place du Maquis du Vercors;31;31;0;0;0;2023-04-06T13:44:36+02:00;Paris
Reims - Porte d'Asnières;26;20;6;1;5;2023-04-06T13:44:34+02:00;Paris
Centenaire - Sorins;45;44;0;0;0;2023-04-06T13:48:31+02:00;Montreuil
Bercy.;66;2;61;42;19;2023-04-06T13:48:38+02:00;Paris
Damrémont - Caulaincourt;18;18;0;0;0;2023-04-06T13:45:46+02:00;Paris
Brochant - Square des Batignolles;31;21;9;6;3;2023-04-06T13:48:15+02:00;Paris
Franciade - Gabriel Péri;26;22;0;0;0;2023-04-06T13:48:13+02:00;Saint-Denis
Square Raymond Souplex;52;48;1;0;1;2023-04-06T13:45:58+02:00;Paris
Dupont de l'Eure - Gambetta;31;31;0;0;0;2023-04-06T13:43:47+02:00;Paris
Keller - La Roquette;34;28;3;3;0;2023-04-06T13:46:57+02:00;Paris
Poissy - Saint-Germain;25;25;0;0;0;2023-04-06T13:46:59+02:00;Paris
Place des Larris;34;31;3;1;2;2023-04-06T13:46:50+02:00;Fontenay-sous-Bois
Convention - Saint-Charles;19;5;13;9;4;2023-04-06T13:46:00+02:00;Paris
Vistule - Choisy;33;31;2;2;0;2023-04-06T13:45:22+02:00;Paris
Parmentier - Fontaine au Roi;48;42;3;1;2;2023-04-06T13:47:10+02:00;Paris
Nationale - Marcel Duchamp;23;13;10;8;2;2023-04-06T13:44:06+02:00;Paris
Thérèse - Opéra;25;2;21;15;6;2023-04-06T13:48:49+02:00;Paris
Charonne - Philippe-Auguste;32;26;6;2;4;2023-04-06T13:47:38+02:00;Paris
Rougemont - Poissonnière;30;8;22;21;1;2023-04-06T13:48:56+02:00;Paris
Hôtel de Ville de Levallois Perret;26;19;5;3;2;2023-04-06T13:46:40+02:00;Levallois-Perret
Mairie du 15ème;32;30;1;1;0;2023-04-06T13:47:18+02:00;Paris
Roquépine - Malesherbes;37;9;26;13;13;2023-04-06T13:48:23+02:00;Paris
Manin - Crimée;23;20;3;0;3;2023-04-06T13:48:00+02:00;Paris
Mairie de Clichy;51;41;7;5;2;2023-04-06T13:45:01+02:00;Clichy
Square Desnouettes;22;6;15;14;1;2023-04-06T13:48:51+02:00;Paris
Pont de Lodi - Dauphine;23;6;15;7;8;2023-04-06T13:48:08+02:00;Paris
Saint-Blaise - Mouraud;27;22;5;0;5;2023-04-06T13:47:29+02:00;Paris
Romain Rolland;25;17;7;3;4;2023-04-06T13:48:29+02:00;Montrouge
Paul Doumer - La Tour;34;31;1;1;0;2023-04-06T13:41:43+02:00;Paris
Les Juilliottes;21;7;13;7;6;2023-04-06T13:46:40+02:00;Maisons-Alfort
Place de Finlande;25;3;20;16;4;2023-04-06T13:48:56+02:00;Paris
République - Henri Barbusse;32;24;8;3;5;2023-04-06T13:47:40+02:00;Aubervilliers
Gambetta - Michelet;33;31;1;0;1;2023-04-06T13:48:37+02:00;Montreuil
Jeûneurs - Mulhouse;28;20;7;0;7;2023-04-06T13:46:51+02:00;Paris
Ferrus - Saint-Jacques;34;34;0;0;0;2023-04-06T13:44:06+02:00;Paris
Danielle Casanova - Place Vendôme;37;1;36;18;18;2023-04-06T13:48:42+02:00;Paris
Fernand Braudel - Vincent Auriol;36;11;25;11;14;2023-04-06T13:47:31+02:00;Paris
Georges V - François 1er;22;9;13;8;5;2023-04-06T13:47:01+02:00;Paris
Bleue - Trévise;30;22;5;2;3;2023-04-06T13:48:48+02:00;Paris
Faidherbe - Dahomey;44;3;41;39;2;2023-04-06T13:48:14+02:00;Paris
Versailles - Claude Terrasse;46;36;7;5;2;2023-04-06T13:49:05+02:00;Paris
Le Vau - Maurice Bertaux;25;22;0;0;0;2023-04-06T13:45:42+02:00;Paris
Porte Saint-Martin;34;25;8;6;2;2023-04-06T13:47:42+02:00;Paris
Daunou - Louis le Grand;17;4;12;2;10;2023-04-06T13:48:47+02:00;Paris
Parc de Sceaux - Centre-Ville;33;20;13;2;11;2023-04-06T13:48:53+02:00;Sceaux
Mornay - Sully;15;7;9;5;4;2023-04-06T13:49:00+02:00;Paris
Pierre Sarrazin - Saint-Michel;33;7;22;17;5;2023-04-06T13:47:56+02:00;Paris
François 1er - Lincoln;31;4;27;8;19;2023-04-06T13:48:41+02:00;Paris
Bachaumont - Montmartre;33;13;18;14;4;2023-04-06T13:46:06+02:00;Paris
Place Mireille Havet;43;7;34;32;2;2023-04-06T13:48:46+02:00;Paris
Sorbonne - Ecoles;50;31;16;11;5;2023-04-06T13:48:57+02:00;Paris
Place Tony de Graaff;42;36;5;3;2;2023-04-06T13:42:43+02:00;Meudon
Square du Bataclan;20;13;6;6;0;2023-04-06T13:47:32+02:00;Paris
Square Georges Melies;40;19;19;12;7;2023-04-06T13:46:40+02:00;Paris
Montreuil - Voltaire;34;31;3;2;1;2023-04-06T13:46:01+02:00;Paris
Claude Vellefaux - Sambre et Meuse;34;34;0;0;0;2023-04-06T13:44:53+02:00;Paris
Place de l'Eglise - Pantin;30;27;1;1;0;2023-04-06T13:47:37+02:00;Pantin
Place du Canada;29;0;21;8;13;2023-04-06T13:48:57+02:00;Paris
Louis Ganne - Davout;30;29;1;0;1;2023-04-06T13:46:33+02:00;Paris
Lamartine - Faubourg Montmartre;32;19;10;6;4;2023-04-06T13:46:11+02:00;Paris
Censier - Jardin des Plantes;28;3;18;14;4;2023-04-06T13:48:48+02:00;Paris
Mairie du 19ème;27;21;1;0;1;2023-04-06T13:41:55+02:00;Paris
Odessa - Départ;39;32;7;5;2;2023-04-06T13:48:37+02:00;Paris
Jardin Marguerite Long;22;18;4;0;4;2023-04-06T13:44:44+02:00;Paris
Lac Daumesnil - Saint-Maurice;50;50;0;0;0;2023-04-06T13:45:45+02:00;Paris
Melun - Jean Jaurès;28;28;0;0;0;2023-01-15T20:52:13+01:00;Paris
Léon - Doudeauville;13;11;1;1;0;2023-04-06T13:47:06+02:00;Paris
Jean Jaurès - Reine;31;11;17;16;1;2023-04-06T13:48:20+02:00;Boulogne-Billancourt
René Binet - Porte de Montmartre;37;34;3;1;2;2023-04-06T13:46:37+02:00;Paris
Argenson - Château;25;5;19;12;7;2023-04-06T13:45:31+02:00;Neuilly-sur-Seine
Quai Marcel Boyer - Victor Hugo;29;8;20;17;3;2023-04-06T13:47:58+02:00;Ivry-sur-Seine
Butte aux Cailles - Esperance;36;30;5;0;5;2023-04-06T13:48:57+02:00;Paris
Gare de Clichy-Levallois;26;21;4;2;2;2023-04-06T13:47:17+02:00;Levallois-Perret
Roquette - Folie Regnault;52;44;6;4;2;2023-04-06T13:49:02+02:00;Paris
Docteur Calmette - Martre;30;18;9;8;1;2023-04-06T13:49:00+02:00;Clichy
Vignes - Boulainvilliers;21;16;5;1;4;2023-04-06T13:48:27+02:00;Paris
République - Auguste Perret;30;29;1;0;1;2023-04-06T13:46:49+02:00;Villejuif
Tremblay - Lac des Minimes;48;6;42;23;19;2023-04-06T13:47:55+02:00;Paris
Dareau - Broussais;24;20;4;2;2;2023-04-06T13:49:01+02:00;Paris
Terroirs de France - Lheureux;55;11;42;19;23;2023-04-06T13:48:36+02:00;Paris
Beaumarchais - Pas de la Mule;18;4;13;9;4;2023-04-06T13:46:43+02:00;Paris
Brochant - Clichy;53;46;3;2;1;2023-04-06T13:48:55+02:00;Paris
Mairie du 9ème;24;5;18;12;6;2023-04-06T13:48:47+02:00;Paris
Place Marcel Sembat;56;29;25;19;6;2023-04-06T13:47:41+02:00;Boulogne-Billancourt
Boutroux - Porte de Vitry;49;23;23;22;1;2023-04-06T13:47:30+02:00;Paris
René Coty - Parc Montsouris;55;53;1;1;0;2023-04-06T13:48:45+02:00;Paris
Pierre Brossolette - Adolphe Pinard;24;22;2;1;1;2023-04-06T13:44:12+02:00;Malakoff
François Truffaut - Saint Emilion;66;17;47;38;9;2023-04-06T13:48:30+02:00;Paris
Place Centrale;22;21;1;0;1;2023-04-06T13:43:32+02:00;Meudon
Madeleine Michelis - Roule;25;10;12;4;8;2023-04-06T13:47:46+02:00;Neuilly-sur-Seine
Gare de Nanterre Ville;43;14;27;22;5;2023-04-06T13:45:53+02:00;Nanterre
Jessaint - Marx Dormoy;30;26;4;2;2;2023-04-06T13:46:36+02:00;Paris
Cours de Vincennes - Davout;48;21;26;21;5;2023-04-06T13:48:49+02:00;Paris
Moulin de la Pointe;22;20;2;1;1;2023-04-06T13:48:07+02:00;Paris
Charles de Gaulle - Orléans;26;14;12;7;5;2023-04-06T13:48:58+02:00;Neuilly-sur-Seine
Sèvres Rive Gauche;33;32;0;0;0;2023-04-06T13:44:55+02:00;Sèvres
Commandant l'Herminier - Gallieni;17;7;10;5;5;2023-04-06T13:48:58+02:00;Paris
Suffren - Pérignon;46;16;28;16;12;2023-04-06T13:48:59+02:00;Paris
Sambre et Meuse - Villette;25;19;3;1;2;2023-04-06T13:44:20+02:00;Paris
Saint-Fargeau - Mortier;33;33;0;0;0;2023-04-06T13:40:00+02:00;Paris
Station Paris Basketball - Stade Georges Carpentier;40;37;3;2;1;2023-04-06T13:39:28+02:00;Paris
Le Corbusier - Jean Jaurès;46;0;44;35;9;2023-04-06T13:48:37+02:00;Boulogne-Billancourt
Jules Guesde - Laennec;19;18;1;0;1;2023-04-06T13:47:26+02:00;Rosny-sous-Bois
Jean Moulin - Paul Doumer;20;12;8;1;7;2023-04-06T13:48:32+02:00;Montreuil
Guy Môquet - Saint-Ouen;53;49;0;0;0;2023-04-06T13:47:43+02:00;Paris
Jules Guesde - Alsace;25;17;9;5;4;2023-04-06T13:48:31+02:00;Levallois-Perret
Choron - Martyrs;17;12;4;3;1;2023-04-06T13:45:21+02:00;Paris
Véron - Lepic;23;21;0;0;0;2023-04-06T13:48:28+02:00;Paris
Place du Président Salvador Allende;60;57;2;0;2;2023-04-06T13:47:27+02:00;Pantin
Pont De Charenton;18;10;7;7;0;2023-04-06T13:44:46+02:00;Saint-Maurice
Square Edmond Pépin;30;26;3;1;2;2023-04-06T13:46:42+02:00;Le Pré-Saint-Gervais
Senard - Charles Blum;24;16;6;4;2;2023-04-06T13:43:05+02:00;Saint-Cloud
Bastille - Quai de la Rapée;27;0;24;21;3;2023-04-06T13:48:57+02:00;Paris
Gergovie - Vercingétorix;29;24;4;0;4;2023-04-06T13:48:41+02:00;Paris
Clapeyron - Moscou;15;12;3;1;2;2023-04-06T13:48:49+02:00;Paris
Rapp - Place du Général Gouraud;31;13;15;12;3;2023-04-06T13:48:54+02:00;Paris
Paul Klee - Place Augusta Holmes;43;2;40;25;15;2023-04-06T13:48:35+02:00;Paris
Pyramide - Parc Floral;50;37;12;3;9;2023-04-06T13:48:39+02:00;Paris
Hôpital Robert Debré;33;28;2;0;2;2023-04-06T13:41:10+02:00;Paris
Demi-Lune - Aristide Briand;20;18;0;0;0;2023-04-06T13:48:13+02:00;Montreuil
Averroès - Aimé Césaire;19;14;4;3;1;2023-04-06T13:44:40+02:00;Pantin
Bois de Vincennes - Porte Jaune;35;34;0;0;0;2023-04-06T13:48:34+02:00;Paris
Place du Front Populaire - George Sand;35;18;15;1;14;2023-04-06T13:48:47+02:00;Saint-Denis
Pré Saint-Gervais - Lilas;28;27;0;0;0;2023-04-06T13:43:42+02:00;Paris
Paul Barruel - Vaugirard;39;38;1;0;1;2023-04-06T13:40:50+02:00;Paris
Auguste Blanqui - Glacière;60;60;0;0;0;2023-04-06T13:48:01+02:00;Paris
Square de la rue Pixérécourt;15;13;0;0;0;2023-04-06T13:40:50+02:00;Paris
Boussingault - Tolbiac;28;25;3;3;0;2023-04-06T13:48:11+02:00;Paris
Athènes - Clichy;20;5;15;6;9;2023-04-06T13:48:33+02:00;Paris
Jacquard - Ternaux;39;34;3;2;1;2023-04-06T13:48:35+02:00;Paris
Parc Suzanne Lenglen;52;17;33;23;10;2023-04-06T13:46:59+02:00;Paris
Alexander Fleming - Belvédère;31;29;1;0;1;2023-04-06T13:43:12+02:00;Paris
Cimetière d'Issy-les-Moulineaux;24;23;1;0;1;2023-04-06T13:47:56+02:00;Issy-les-Moulineaux
Honoré d'Estienne d'Ovres - Grilles;18;11;4;1;3;2023-04-06T13:45:49+02:00;Pantin
Neuilly - Petit;16;3;9;5;4;2023-04-06T13:48:32+02:00;Clichy
Santé - Arago;38;36;2;1;1;2023-04-06T13:49:06+02:00;Paris
Pelée - Alphonse Baudin;38;20;17;16;1;2023-04-06T13:47:21+02:00;Paris
Gare du Nord - Place de Valenciennes;25;18;5;2;3;2023-04-06T13:47:02+02:00;Paris
Joseph Sansboeuf - Saint Lazare;18;2;16;8;8;2023-04-06T13:47:34+02:00;Paris
Place de la Montagne du Goulet;21;8;11;11;0;2023-04-06T13:47:59+02:00;Paris
Place Jules Ferry;28;28;0;0;0;2023-04-06T13:48:33+02:00;Montrouge
Longchamp - Place d'Iéna;40;9;30;6;24;2023-04-06T13:48:19+02:00;Paris
Gare de l'Est - Fidélité;15;9;3;2;1;2023-04-06T13:48:54+02:00;Paris
Louis Blanc - Jemmapes;31;27;3;1;2;2023-04-06T13:46:07+02:00;Paris
Ecole Militaire - Place Joffre;26;25;1;1;0;2023-04-06T13:48:10+02:00;Paris
Charles Lecocq - Lecourbe;30;26;4;4;0;2023-04-06T13:48:26+02:00;Paris
Gare du Nord - Denain;20;15;2;1;1;2023-04-06T13:47:02+02:00;Paris
Quai de Valmy;26;21;2;1;1;2023-04-06T13:47:44+02:00;Paris
Hôtel de ville de Fontenay-sous-Bois;20;19;1;0;1;2023-04-06T13:45:15+02:00;Fontenay-sous-Bois
Eylau - Trocadéro;24;14;8;3;5;2023-04-06T13:48:51+02:00;Paris
Pierre Levée - Fontaine Timbaud;23;19;3;1;2;2023-04-06T13:45:40+02:00;Paris
Gare de Lyon - Van Gogh;51;0;49;30;19;2023-04-06T13:49:00+02:00;Paris
Carnot - Général Lanrezac;30;30;0;0;0;2018-05-21T07:30:29+02:00;Paris
Edouard Vaillant - Galliéni;49;49;0;0;0;2020-08-14T04:12:17+02:00;Bagnolet
Résistance - Hoche;29;24;3;1;2;2023-04-06T13:43:46+02:00;Montreuil
Mazagran - Pierre de Coubertin;15;11;4;1;3;2023-04-06T13:46:03+02:00;Paris
Commerce - Letellier;44;15;29;26;3;2023-04-06T13:48:56+02:00;Paris
Pierre Demours - Laugier;37;26;7;3;4;2023-04-06T13:48:40+02:00;Paris
Fessart - Château;20;14;5;5;0;2023-04-06T13:45:59+02:00;Boulogne-Billancourt
Metz - Faubourg Saint-Denis;48;31;15;12;3;2023-04-06T13:47:27+02:00;Paris
Brancion - Lefebvre;11;9;1;1;0;2023-04-06T13:49:01+02:00;Paris
Censier - Santeuil;69;55;14;9;5;2023-04-06T13:48:48+02:00;Paris
Hôtel de Ville de Fontenay-aux-Roses;34;31;3;0;3;2023-04-06T13:45:03+02:00;Fontenay-aux-Roses
Mairie de Neuilly sur Seine;31;21;9;2;7;2023-04-06T13:48:46+02:00;Neuilly-sur-Seine
Vinaigriers - Magenta;25;22;1;1;0;2023-04-06T13:46:48+02:00;Paris
Chancé Milly - Cimetière Communal Sud;32;30;1;1;0;2023-04-06T13:46:11+02:00;Clichy
Vanne - Général de Gaulle;25;20;5;0;5;2023-04-06T13:47:57+02:00;Montrouge
Botzaris - Crimée;21;16;5;0;5;2023-04-06T13:48:41+02:00;Paris
Vanne - Saussaies;20;11;9;1;8;2023-04-06T13:44:00+02:00;Cachan
Saint-Didier - Raymond Poincaré;17;11;6;4;2;2023-04-06T13:48:50+02:00;Paris
Pierre Lefaucheux - Traversière;35;18;16;11;5;2023-04-06T13:48:25+02:00;Boulogne-Billancourt
Cours de l'Ile Seguin - Parc Billancourt;29;15;11;8;3;2023-04-06T13:49:04+02:00;Boulogne-Billancourt
Victor Cresson - Telles de la Poterie;31;11;20;12;8;2023-04-06T13:48:51+02:00;Issy-les-Moulineaux
Belleville - Couronnes;50;45;2;1;1;2023-04-06T13:48:55+02:00;Paris
Pontoise - La Tournelle;23;2;17;11;6;2023-04-06T13:49:01+02:00;Paris
Place Fernand Forest;33;0;32;29;3;2023-04-06T13:48:37+02:00;Paris
Daumesnil - Hébrard;40;12;27;22;5;2023-04-06T13:49:04+02:00;Paris
Marcel Yol - Jullien;30;23;5;1;4;2023-04-06T13:46:27+02:00;Vanves
Jardin de l'Hospice Debrousse;23;23;0;0;0;2023-04-06T13:45:31+02:00;Paris
Gare Montparnasse - Edgar Quinet;33;17;16;5;11;2023-04-06T13:48:34+02:00;Paris
Paul Signac - Aristide Briand;35;30;2;0;2;2023-04-06T13:46:16+02:00;Montreuil
Wurtz - Tolbiac;28;26;1;0;1;2023-04-06T13:48:51+02:00;Paris
Charles de Gaulle - Graviers;0;0;0;0;0;2022-12-05T06:50:36+01:00;Neuilly-sur-Seine
Marc Sangnier - Division Leclerc;24;3;18;16;2;2023-04-06T13:47:45+02:00;Cachan
Stade de France;44;28;16;6;10;2023-04-06T13:47:08+02:00;Saint-Denis
Convention - Vaugirard;48;44;3;3;0;2023-04-06T13:47:14+02:00;Paris
Porte d'Italie;13;12;1;0;1;2023-04-06T13:41:27+02:00;Paris
Paul Vaillant-Couturier - Gare RER;26;3;20;15;5;2023-04-06T13:49:02+02:00;Vitry-sur-Seine
Vitruve - Davout;23;23;0;0;0;2023-04-06T13:47:18+02:00;Paris
Raffet - Montmorency;42;25;15;3;12;2023-04-06T13:45:43+02:00;Paris
Place de la Porte de Passy;36;32;4;2;2;2023-04-06T13:47:15+02:00;Paris
Ivry - Simone Weil;18;11;6;2;4;2023-04-06T13:48:25+02:00;Paris
Damrémont - Ordener;30;27;0;0;0;2023-04-06T13:46:55+02:00;Paris
Cimetière de Boulogne-Billancourt;40;16;22;21;1;2023-04-06T13:48:13+02:00;Boulogne-Billancourt
Quai aux Fleurs - Pont Saint-Louis;21;17;4;2;2;2023-04-06T13:48:23+02:00;Paris
Ranelagh - Maison de la Radio;22;4;17;15;2;2023-04-06T13:48:37+02:00;Paris
Batignolles - Beudant;44;40;2;0;2;2023-04-06T13:48:30+02:00;Paris
Gare SNCF Vanves-Malakoff;51;51;0;0;0;2023-04-06T13:41:14+02:00;Vanves
Place de Lévis;48;44;2;0;2;2023-04-06T13:45:35+02:00;Paris
Place Saint-Ferdinand;38;32;6;3;3;2023-04-06T13:42:40+02:00;Paris
La Motte-Picquet - Grenelle;34;1;30;28;2;2023-04-06T13:48:57+02:00;Paris
Docteurs Déjérine - Pte de Montreuil;20;19;1;1;0;2023-04-06T13:47:23+02:00;Paris
Arcole - Notre-Dame;31;26;5;4;1;2023-04-06T13:48:30+02:00;Paris
Malakoff - Place de la Porte Maillot;31;12;4;2;2;2023-04-06T13:44:06+02:00;Paris
Quai de la Gare - Pont de Bercy;30;7;21;13;8;2023-04-06T13:48:51+02:00;Paris
Jean-Pierre Timbaud - Vaucouleurs;47;38;8;6;2;2023-04-06T13:46:42+02:00;Paris
Place de l'Insurrection d'Août 1944;30;12;17;15;2;2023-04-06T13:48:03+02:00;Ivry-sur-Seine
Bruneseau - Quai d'Ivry;48;9;36;29;7;2023-04-06T13:47:53+02:00;Ivry-sur-Seine
Camille Groult - Guy Môquet;22;7;15;14;1;2023-04-06T13:40:51+02:00;Vitry-sur-Seine
André Maurois - Joseph et Marie Hackin;29;15;12;3;9;2023-04-06T13:49:01+02:00;Paris
Raspail - Albert Schweitzer;28;6;20;20;0;2023-04-06T13:47:54+02:00;Gentilly
Buzenval - Avron;50;48;2;2;0;2023-04-06T13:46:59+02:00;Paris
Jean Jaurès - Ouvrières Pivéreuses;20;17;0;0;0;2023-04-06T13:41:04+02:00;Pantin
Mairie de Romainville;17;15;0;0;0;2023-04-06T13:41:39+02:00;Romainville
Marché aux fleurs;23;6;15;9;6;2023-04-06T13:49:01+02:00;Paris
George V - Christophe Colomb;24;0;24;8;16;2023-04-06T13:47:01+02:00;Paris
Place de l'Europe - Quai de Bercy;17;8;9;8;1;2023-04-06T13:48:18+02:00;Charenton-le-Pont
Amaury Duval - Gabriel Péri;36;33;2;0;2;2023-04-06T13:48:55+02:00;Montrouge
Paris - Laitières;22;0;22;10;12;2023-04-06T13:48:54+02:00;Vincennes
Hôpital - Campo-Formio;16;14;2;0;2;2023-04-06T13:48:18+02:00;Paris
Louis Pasteur - Albert Petit;31;27;3;0;3;2023-04-06T13:41:50+02:00;Bagneux
Square Alban Satragne;30;24;3;1;2;2023-04-06T13:49:07+02:00;Paris
Jean Moulin - Place Victor et Hélène Basch;41;40;1;1;0;2023-04-06T13:47:20+02:00;Paris
Proudhon - Président Wilson;30;30;0;0;0;2023-04-06T13:46:23+02:00;Saint-Denis
Louis Rolland - République;26;21;4;1;3;2023-04-06T13:45:35+02:00;Montrouge
Jean Calvin - Tournefort;28;13;15;10;5;2023-04-06T13:49:04+02:00;Paris
Emeriau - Beaugrenelle;74;10;61;56;5;2023-04-06T13:48:57+02:00;Paris
Charles Gide - Fort de Bicêtre;30;18;10;1;9;2023-04-06T13:46:18+02:00;Le Kremlin-Bicêtre
Faubourg Poissonnière - Dunkerque;30;22;6;1;5;2023-04-06T13:46:26+02:00;Paris
Temple - Charlot;45;21;18;12;6;2023-04-06T13:48:59+02:00;Paris
Victor Hugo - La Pompe;41;11;18;2;16;2023-04-06T13:48:23+02:00;Paris
Place Nationale - Château-des-Rentiers;18;17;1;0;1;2023-04-06T13:45:22+02:00;Paris
Colmar - Victor Hugo;32;18;10;4;6;2023-04-06T13:47:41+02:00;Rueil-Malmaison
Place de Barcelone - Mirabeau;55;13;35;32;3;2023-04-06T13:47:51+02:00;Paris
Charonne - Pierre Bayle;23;22;1;0;1;2023-04-06T13:47:53+02:00;Paris
Théâtre de La Garenne;20;15;3;1;2;2023-04-06T13:48:28+02:00;La Garenne-Colombes
Place Lafayette;62;0;59;38;21;2023-04-06T13:49:06+02:00;Issy-les-Moulineaux
Président Wilson - Baudin;28;10;16;9;7;2023-04-06T13:46:48+02:00;Levallois-Perret
Monceau - Malesherbes;38;25;11;3;8;2023-04-06T13:46:07+02:00;Paris
Jourdan - Monticelli;30;29;1;0;1;2023-04-06T13:46:59+02:00;Paris
Lucien Lanternier - Le Luth;27;8;19;12;7;2023-04-06T13:47:35+02:00;Gennevilliers
Porte d'Asnières;36;31;2;1;1;2023-04-06T13:46:00+02:00;Paris
Rond-Point de la Chapelle;0;0;0;0;0;2023-02-21T23:23:33+01:00;Paris
Gaston Tessier - Rosa Parks RER;37;34;1;1;0;2023-04-06T13:48:45+02:00;Paris
La Jarry - Place Diderot;25;24;1;0;1;2023-04-06T13:46:24+02:00;Vincennes
Lobau - Hôtel de Ville;60;35;23;22;1;2023-04-06T13:48:38+02:00;Paris
Place Jacques et Thérèse Tréfouël;43;26;17;14;3;2023-04-06T13:48:08+02:00;Paris
Assas - Luxembourg;33;2;30;6;24;2023-04-06T13:47:33+02:00;Paris
Lucien Bossoutrot - Général Martial Vallin;39;12;26;21;5;2023-04-06T13:48:44+02:00;Paris
Mazagran - Bonne Nouvelle;25;18;7;2;5;2023-04-06T13:44:47+02:00;Paris
Pergolèse - Malakoff;38;28;9;2;7;2023-04-06T13:48:27+02:00;Paris
Brillat-Savarin - Küss;21;19;1;1;0;2023-04-06T13:41:56+02:00;Paris
Vaugirard - Pasteur;21;13;8;3;5;2023-04-06T13:48:14+02:00;Paris
Estienne d'Orves - Henri Ginoux;31;31;0;0;0;2023-04-06T13:43:54+02:00;Montrouge
Voltaire - Anatole France;27;9;17;11;6;2023-04-06T13:47:19+02:00;Levallois-Perret
Bobillot - Paulin Mery;23;22;1;1;0;2023-04-06T13:48:56+02:00;Paris
Quai de l'Oise - Aisne;30;23;2;1;1;2023-04-06T13:48:30+02:00;Paris
Jacques Kellner - Saint-Ouen;45;42;3;2;1;2023-04-06T13:47:24+02:00;Paris
Place du 14 Juillet;22;19;0;0;0;2023-04-06T13:47:36+02:00;Malakoff
Javel - André Citroën;45;19;19;19;0;2023-04-06T13:48:11+02:00;Paris
Charonne - Bureau;47;43;4;0;4;2023-04-06T13:47:42+02:00;Paris
Gare de Lyon - Chalon;45;3;41;29;12;2023-04-06T13:48:16+02:00;Paris
Square Louise Michel;36;24;11;7;4;2023-04-06T13:47:41+02:00;Paris
Benjamin Delessert - Jean Lolive;21;18;2;1;1;2023-04-06T13:45:45+02:00;Pantin
Douai - Pierre Fontaine;25;17;5;1;4;2023-04-06T13:49:01+02:00;Paris
Place de la Gare;46;15;30;30;0;2023-04-06T13:48:57+02:00;Maisons-Alfort
Portugais - Kléber;26;7;19;1;18;2023-04-06T13:47:32+02:00;Paris
Place Mongolfier;39;1;36;32;4;2023-04-06T13:48:54+02:00;Saint-Maurice
Place Edmond Michelet;23;4;18;11;7;2023-04-06T13:48:50+02:00;Paris
Italie - Jardin Joan Miro;26;25;1;0;1;2023-04-06T13:47:08+02:00;Paris
Emile Zola - Fondary;42;9;32;29;3;2023-04-06T13:49:07+02:00;Paris
Gare de la Garenne-Colombes;28;18;7;6;1;2023-04-06T13:43:51+02:00;Colombes
Taitbout - La Fayette;53;19;32;19;13;2023-04-06T13:48:47+02:00;Paris
Mairie de quartier du Plateau - Mont-Valérien;20;12;8;2;6;2023-04-06T13:47:56+02:00;Nanterre
Charles Tillon - Cimetière Communal;30;18;6;1;5;2023-04-06T13:48:13+02:00;Aubervilliers
Paul Vaillant-Couturier - Victor Hugo;36;10;24;16;8;2023-04-06T13:46:49+02:00;Levallois-Perret
La Motte-Picquet - La Tour Maubourg;40;9;28;28;0;2023-04-06T13:49:04+02:00;Paris
Berthier - Place Stuart Merril;37;30;6;3;3;2023-04-06T13:48:24+02:00;Paris
Delizy - Louis Nadot;22;10;10;4;6;2023-04-06T13:48:22+02:00;Pantin
Blaise-Desgoffe - Vaugirard;32;6;23;7;16;2023-04-06T13:49:04+02:00;Paris
Saint-Mandé - Fabre d'Eglantine;34;31;3;0;3;2023-04-06T13:49:06+02:00;Paris
Goutte d'or - Barbès;20;18;2;0;2;2023-04-06T13:45:34+02:00;Paris
Toqueville - Cardinet;33;32;0;0;0;2023-04-06T13:43:52+02:00;Paris
Mairie de Clamart;33;28;1;1;0;2023-04-06T13:39:45+02:00;Clamart
Cambronne - Villa Croix Nivert;62;26;35;33;2;2023-04-06T13:48:38+02:00;Paris
Place Jeanne d'Arc;36;32;3;1;2;2023-04-06T13:48:33+02:00;Paris
Placette Grégoire Collas;24;10;13;10;3;2023-04-06T13:46:30+02:00;Argenteuil
Bessières - Porte de Clichy;33;4;27;16;11;2023-04-06T13:46:37+02:00;Paris
Porte des Lilas - Faidherbe;39;36;3;1;2;2023-04-06T13:48:45+02:00;Les Lilas
Halles - Bourdonnais;20;4;15;9;6;2023-04-06T13:48:56+02:00;Paris
Square Bela Bartok;24;3;20;20;0;2023-04-06T13:46:23+02:00;Paris
Quai du Président Roosevelt - Pont Aval;30;0;30;10;20;2023-04-06T13:47:08+02:00;Paris
Fort d'Aubervilliers;22;15;5;3;2;2023-04-06T13:47:48+02:00;Aubervilliers
Maréchal Joffre - Verdun;20;19;0;0;0;2023-04-06T13:47:05+02:00;Fontenay-sous-Bois
Place Ginette Hamelin;51;12;37;29;8;2023-04-06T13:47:11+02:00;Paris
Rochechouart - Martyrs;20;17;1;0;1;2023-04-06T13:49:06+02:00;Paris
Gare du Stade;20;6;13;13;0;2023-04-06T13:49:00+02:00;Colombes
Île de la Jatte;23;15;8;5;3;2023-04-06T13:48:21+02:00;Neuilly-sur-Seine
Saint-Germain - Ciseaux;18;17;0;0;0;2023-04-06T13:43:43+02:00;Paris
Lemercier - Cardinet;24;19;4;4;0;2023-04-06T13:46:12+02:00;Paris
Clichy - Douai;32;26;3;1;2;2023-04-06T13:48:11+02:00;Paris
Balzac - Olympes de Gouges;28;3;23;13;10;2023-04-06T13:48:07+02:00;Vitry-sur-Seine
Esplanade du Foncet - Camille Desmoulins;28;1;27;22;5;2023-04-06T13:48:43+02:00;Issy-les-Moulineaux
Place Saint-Just;22;11;11;4;7;2023-04-06T13:48:52+02:00;Vitry-sur-Seine
Joseph Dijon - Ornano;37;32;1;1;0;2023-04-06T13:47:55+02:00;Paris
Gérando - Rochechouart;21;18;2;0;2;2023-04-06T13:43:23+02:00;Paris
Square Denise Buisson;45;36;6;2;4;2023-04-06T13:48:12+02:00;Montreuil
Suffren - Champ de Mars;23;9;14;9;5;2023-04-06T13:48:09+02:00;Paris
Picpus - Louis Braille;44;40;3;2;1;2023-04-06T13:48:15+02:00;Paris
Centre Georges Pompidou;26;9;17;10;7;2023-04-06T13:47:22+02:00;Paris
Godot de Mauroy - Madeleine;22;1;19;14;5;2023-04-06T13:45:33+02:00;Paris
Auguste Blanqui - Corvisart;26;26;0;0;0;2023-04-06T13:39:08+02:00;Paris
Madagascar - Meuniers;33;29;2;1;1;2023-04-06T13:48:05+02:00;Paris
Mstislav Rostropovitch - Berthier;18;6;12;6;6;2023-04-06T13:43:55+02:00;Paris
Charenton - Prague;26;1;24;23;1;2023-04-06T13:49:00+02:00;Paris
Londres - Place d'Estienne d'Orves;25;6;19;11;8;2023-04-06T13:48:07+02:00;Paris
Square Etienne Jarousse;25;25;0;0;0;2023-04-06T13:45:26+02:00;Vanves
Pont de Suresnes;24;24;0;0;0;2023-02-19T00:47:41+01:00;Suresnes
Cloître Saint-Merri - Renard;32;19;11;6;5;2023-04-06T13:45:34+02:00;Paris
Dunkerque - Trudaine;16;10;5;0;5;2023-04-06T13:42:25+02:00;Paris
Champs-Elysees - Bassano;25;25;0;0;0;2021-02-21T20:09:18+01:00;Paris
Chemin de Bretagne;29;5;23;23;0;2023-04-06T13:48:40+02:00;Issy-les-Moulineaux
Hôpital Necker;40;19;20;16;4;2023-04-06T13:47:45+02:00;Paris
Place Nelson Mandela;30;12;18;2;16;2023-04-06T13:47:46+02:00;Nanterre
Bourg l'Abbé - Saint-Martin;42;21;18;13;5;2023-04-06T13:49:01+02:00;Paris
Place Monge;21;21;0;0;0;2023-04-06T13:43:35+02:00;Paris
Mairie du 8ème;14;10;4;2;2;2023-04-06T13:46:41+02:00;Paris
Crozatier - Faubourg Saint-Antoine;42;6;36;29;7;2023-04-06T13:49:05+02:00;Paris
Jules Guesdes - Général de Gaulle;24;24;0;0;0;2023-04-06T13:44:36+02:00;Issy-les-Moulineaux
Glacière - Soeur Catherine Marie;40;34;5;2;3;2023-04-06T13:48:00+02:00;Paris
Marché Saint-Germain;21;1;18;17;1;2023-04-06T13:48:17+02:00;Paris
Rottembourg - Général Michel Bizot;43;25;14;14;0;2023-04-06T13:47:52+02:00;Paris
Place Aimé Césaire;27;23;4;0;4;2023-04-06T13:47:11+02:00;Clamart
Geoffroy - Marie;20;3;16;11;5;2023-04-06T13:47:42+02:00;Paris
Gare RER - Malleret-Joinville;20;17;2;1;1;2023-04-06T13:42:41+02:00;Alfortville
Place Joffre - Frédéric le Play;38;21;17;6;11;2023-04-06T13:48:20+02:00;Paris
Hôtel de Ville de Sèvres;32;23;9;2;7;2023-04-06T13:44:34+02:00;Sèvres
Place de Rungis;32;32;0;0;0;2023-04-06T13:48:09+02:00;Paris
Jean Monnet - Iles;32;10;22;21;1;2023-04-06T13:48:10+02:00;Issy-les-Moulineaux
Vivaldi - Antoine-Julien Hénard;27;26;1;0;1;2023-04-06T13:48:28+02:00;Paris
Parc Eli Lotar;20;8;11;7;4;2023-04-06T13:48:11+02:00;Aubervilliers
Marché Saint-Quentin;15;12;1;0;1;2023-04-06T13:41:09+02:00;Paris
Leredde - Tolbiac;44;17;26;15;11;2023-04-06T13:48:53+02:00;Paris
Vivienne - Montmartre;39;9;28;13;15;2023-04-06T13:47:30+02:00;Paris
Place Charles Michels;37;2;33;30;3;2023-04-06T13:47:55+02:00;Paris
Place d'Italie - Vincent Auriol;40;40;0;0;0;2023-04-06T13:45:29+02:00;Paris
Choisy - Tolbiac;26;15;1;0;1;2023-04-06T13:48:01+02:00;Paris
Buffon - Jardin des Plantes;30;1;28;18;10;2023-04-06T13:45:36+02:00;Paris
Benoît Frachon - République;30;22;8;4;4;2023-04-06T13:48:19+02:00;Paris
Louis Xavier de Ricard - Ancienne Mairie;34;29;1;0;1;2023-04-06T13:48:08+02:00;Fontenay-sous-Bois
Jean Jaurès - Jules Jacquemin;24;21;2;0;2;2023-04-06T13:44:27+02:00;Le Pré-Saint-Gervais
Lebrun - Colonel Fabien;27;27;0;0;0;2023-04-06T13:41:57+02:00;Vitry-sur-Seine
Mairie du 14ème;32;30;2;1;1;2023-04-06T13:46:53+02:00;Paris
Bagnolet - Orteaux;36;34;0;0;0;2023-04-06T13:39:41+02:00;Paris
Marne - Charles de Gaulle;27;23;3;0;3;2023-04-06T13:47:13+02:00;Alfortville
Gare d'Argenteuil;40;13;24;15;9;2023-04-06T13:49:01+02:00;Argenteuil
Saint-Benoît - Jacob;23;0;22;6;16;2023-04-06T13:49:07+02:00;Paris
Abbé Groult - Convention;12;9;2;2;0;2023-04-06T13:48:51+02:00;Paris
Didot - Place de Moro-Giafferi;22;21;0;0;0;2023-04-06T13:43:36+02:00;Paris
Bibliothèque Nationale - Richelieu;17;4;13;10;3;2023-04-06T13:40:18+02:00;Paris
Davout - Volga;28;25;3;1;2;2023-04-06T13:46:55+02:00;Paris
Cherche-Midi - Hôpital Necker;38;31;5;2;3;2023-04-06T13:48:14+02:00;Paris
Porte de la Muette;36;25;11;1;10;2023-04-06T13:47:31+02:00;Paris
Richard Lenoir - Voltaire;25;7;17;15;2;2023-04-06T13:47:36+02:00;Paris
Bruant - Vincent Auriol;25;4;20;18;2;2023-04-06T13:48:06+02:00;Paris
Condorcet - Turgot;20;11;9;3;6;2023-04-06T13:47:55+02:00;Paris
Bréguet - Sabin;33;17;13;10;3;2023-04-06T13:48:55+02:00;Paris
Villiers - Batignolles;23;18;2;1;1;2023-04-06T13:49:05+02:00;Paris
Jardins d'Eole;20;16;1;1;0;2023-04-06T13:44:49+02:00;Paris
Croix Nivert - Square Saint-Lambert;47;23;24;20;4;2023-04-06T13:46:20+02:00;Paris
Raymond Poincaré - Place Victor Hugo;25;8;13;2;11;2023-04-06T13:47:34+02:00;Paris
Landy - Heurtault;30;6;21;13;8;2023-04-06T13:48:37+02:00;Aubervilliers
Paul Bodin - Clichy;34;26;6;5;1;2023-04-06T13:47:48+02:00;Paris
Paradis - Hauteville;31;13;15;14;1;2023-04-06T13:47:25+02:00;Paris
Place des Droits de l'Enfant;24;21;2;0;2;2023-04-06T13:48:26+02:00;Paris
Stalingrad - Rigollots;51;46;0;0;0;2023-04-06T13:47:52+02:00;Fontenay-sous-Bois
Ecoles - Carmes;36;2;31;14;17;2023-04-06T13:47:59+02:00;Paris
Gare du Nord - Saint-Vincent de Paul;24;22;1;1;0;2023-04-06T13:48:44+02:00;Paris
Porte de Bagnolet;33;29;3;1;2;2023-04-06T13:47:31+02:00;Paris
Plantes - Moulin Vert;45;41;2;2;0;2023-04-06T13:47:44+02:00;Paris
Bourdon - Pont Morland;52;7;44;37;7;2023-04-06T13:49:06+02:00;Paris
Flandrin - Longchamp;42;7;29;12;17;2023-04-06T13:44:53+02:00;Paris
Reuilly - Place Felix Eboue;42;37;3;1;2;2023-04-06T13:47:52+02:00;Paris
Porte Molitor;60;7;51;37;14;2023-04-06T13:46:30+02:00;Paris
Crevaux - Bugeaud;31;23;8;3;5;2023-04-06T13:46:48+02:00;Paris
Place de la Madeleine - Royale;26;4;21;13;8;2023-04-06T13:49:00+02:00;Paris
Cité Riverin - Château d'Eau;18;0;16;11;5;2023-04-06T13:48:58+02:00;Paris
Gare RER les Grésillons;22;13;7;5;2;2023-04-06T13:41:35+02:00;Asnières-sur-Seine
Charles Frérot - Albert Guilpin;30;19;11;11;0;2023-04-06T13:48:42+02:00;Gentilly
Poissonniers - Championnet;28;16;3;0;3;2023-04-06T13:46:54+02:00;Paris
Chevreuse - Montparnasse;15;1;14;3;11;2023-04-06T13:48:53+02:00;Paris
Cambon - Rivoli;40;1;38;26;12;2023-04-06T13:48:24+02:00;Paris
Place de la Nation - Picpus;36;36;0;0;0;2023-04-06T13:45:24+02:00;Paris
Jules Vallès - Charonne;23;17;3;2;1;2023-04-06T13:48:55+02:00;Paris
Maxime Gorki - Louis Aragon;20;18;2;1;1;2023-04-06T13:44:54+02:00;Villejuif
Henri Ravera - Gabriel Péri;30;28;1;0;1;2023-04-06T13:45:29+02:00;Bagneux
Grande Truanderie - Saint-Denis;33;19;12;8;4;2023-04-06T13:46:49+02:00;Paris
Perle - Vieille du Temple;36;15;20;13;7;2023-04-06T13:49:01+02:00;Paris
Sèvres - Lecourbe;62;28;33;25;8;2023-04-06T13:49:02+02:00;Paris
Gare Montparnasse - Arrivée;43;15;28;23;5;2023-04-06T13:47:33+02:00;Paris
Square Claude Bernard;30;18;12;9;3;2023-04-06T13:49:08+02:00;Paris
Roger Salengro - Général de Gaulle;27;5;21;20;1;2023-04-06T13:47:23+02:00;Champigny-sur-Marne
Epée de Bois - Mouffetard;63;52;11;9;2;2023-04-06T13:47:17+02:00;Paris
Murat - Porte de Saint-Cloud;38;15;20;14;6;2023-04-06T13:47:46+02:00;Paris
Claude Vellefaux - Hôpital Saint-Louis;32;30;1;0;1;2023-04-06T13:44:11+02:00;Paris
Diane Arbus;38;30;5;3;2;2023-04-06T13:46:34+02:00;Paris
Phalsbourg - Villiers;20;17;2;2;0;2023-04-06T13:44:43+02:00;Paris
Cadix - Hameau;37;9;26;26;0;2023-04-06T13:47:57+02:00;Paris
Molitor - Michel-Ange;52;16;30;22;8;2023-04-06T13:48:44+02:00;Paris
Camille Risch - Paul Armangot;25;24;1;1;0;2023-04-06T13:48:07+02:00;Vitry-sur-Seine
Place des Abbesses;12;11;1;0;1;2023-04-06T13:47:33+02:00;Paris
Reuilly - Daumesnil;36;25;8;3;5;2023-04-06T13:49:01+02:00;Paris
Pyrénées - Avron;32;29;3;0;3;2023-04-06T13:46:59+02:00;Paris
Charentonneau - Maisons Alfort;20;6;13;11;2;2023-04-06T13:43:50+02:00;Maisons-Alfort
Herschel - Observatoire;37;24;13;1;12;2023-04-06T13:45:49+02:00;Paris
Sorbier - Ménilmontant;24;22;1;1;0;2023-04-06T13:48:36+02:00;Paris
Gare de Reuilly - Picpus;28;25;3;1;2;2023-04-06T13:49:04+02:00;Paris
Mairie du 16ème;35;32;3;0;3;2023-04-06T13:45:23+02:00;Paris
Pergolèse - Marbeau;27;17;2;0;2;2023-04-06T13:46:54+02:00;Paris
Cité Vaneau;26;8;17;14;3;2023-04-06T13:48:09+02:00;Paris
Louis Lumière.;22;17;3;0;3;2023-04-06T13:45:10+02:00;Paris
Maine - Liancourt;27;23;4;2;2;2023-04-06T13:48:32+02:00;Paris
Mairie d'Issy;41;25;15;11;4;2023-04-06T13:48:56+02:00;Issy-les-Moulineaux
Leibniz - Jean Dollfus;32;24;7;4;3;2023-04-06T13:47:48+02:00;Paris
Gambetta - Père Lachaise;29;28;1;0;1;2023-04-06T13:44:16+02:00;Paris
Jourdan - Cité Universitaire;39;35;3;1;2;2023-04-06T13:45:00+02:00;Paris
Niger - Soult;24;21;2;2;0;2023-04-06T13:40:17+02:00;Paris
Place de la Nation - Charonne;36;34;2;2;0;2023-04-06T13:47:11+02:00;Paris
Quai de Béthune - Pont de la Tournelle;25;19;4;1;3;2023-04-06T13:48:09+02:00;Paris
Beaubourg - Michel-le-Comte;17;5;12;5;7;2023-04-06T13:47:43+02:00;Paris
Centquatre;42;36;2;1;1;2023-04-06T13:48:14+02:00;Paris
Porte de Clignancourt - Ney;40;24;13;9;4;2023-04-06T13:46:37+02:00;Paris
Square Montholon;21;13;8;6;2;2023-04-06T13:46:35+02:00;Paris
Turbigo - Française;16;3;11;7;4;2023-04-06T13:48:48+02:00;Paris
Gare Saint-Lazare - Stockholm;32;20;10;4;6;2023-04-06T13:47:29+02:00;Paris
Cordelières - Arago;46;23;22;20;2;2023-04-06T13:48:16+02:00;Paris
Petit - Georges Thill;23;20;1;0;1;2023-04-06T13:44:04+02:00;Paris
Parme - Clichy;24;18;5;2;3;2023-04-06T13:45:07+02:00;Paris
Emile Reynaud - Porte de la Villette;22;17;4;1;3;2023-04-06T13:48:49+02:00;Paris
Louis Blanc - La Chapelle;21;18;3;1;2;2023-04-06T13:48:22+02:00;Paris
Chausson - Gabriel Péri;22;11;9;4;5;2023-04-06T13:46:33+02:00;Gennevilliers
Bargue -  Dutot;21;19;2;1;1;2023-04-06T13:41:30+02:00;Paris
Pyrénées - Plaine;12;9;3;2;1;2023-04-06T13:48:02+02:00;Paris
Place de l'Europe - Alfortville;24;9;15;10;5;2023-04-06T13:43:36+02:00;Alfortville
Beaumarchais - Saint-Gilles;51;32;19;16;3;2023-04-06T13:46:55+02:00;Paris
Traktir - Foch;22;17;3;1;2;2023-04-06T13:48:29+02:00;Paris
Charenton - Jardiniers;31;28;2;0;2;2023-04-06T13:45:42+02:00;Paris
Sèvres - Général Leclerc;30;1;29;13;16;2023-04-06T13:47:13+02:00;Boulogne-Billancourt
Maurice d'Ocagne - General Maudhuy;30;29;1;0;1;2023-04-06T13:48:47+02:00;Paris
Louis le Grand - Italiens;33;0;32;16;16;2023-04-06T13:47:59+02:00;Paris
Place de la Fraternité;22;12;6;1;5;2023-04-06T13:49:04+02:00;Montreuil
Saint-Denis - Université;24;20;4;1;3;2023-04-06T13:45:09+02:00;Saint-Denis
Turbigo - Réaumur;31;10;18;17;1;2023-04-06T13:48:50+02:00;Paris
Bourse du Travail;17;6;9;7;2;2023-04-06T13:45:44+02:00;Paris
Dunkerque - Alsace;20;19;1;0;1;2023-04-06T13:47:38+02:00;Paris
Gare de Bellevue;20;12;8;0;8;2023-04-06T13:48:22+02:00;Meudon
Faubourg Du Temple - Republique;38;26;9;8;1;2023-04-06T13:49:06+02:00;Paris
Bosquet - Saint-Dominique;28;7;20;15;5;2023-04-06T13:48:03+02:00;Paris
Maurice Payret-Dortail;22;18;3;1;2;2023-04-06T13:43:46+02:00;Suresnes
Sarrette - Général Leclerc;22;20;2;1;1;2023-04-06T13:48:45+02:00;Paris
Frères Flavien - Porte des Lilas;23;22;1;0;1;2023-04-06T13:47:02+02:00;Paris
Arsène Houssaye - Champs-Elysées;29;14;14;0;14;2023-04-06T13:48:48+02:00;Paris
Saint-Denis - Réaumur;32;8;20;15;5;2023-04-06T13:48:33+02:00;Paris
Mairie du 10ème;19;9;9;8;1;2023-04-06T13:47:53+02:00;Paris
Parc Roger Salengro;35;32;3;3;0;2023-04-06T13:45:41+02:00;Clichy
Petites Ecuries - Faubourg Saint-Denis;29;1;28;18;10;2023-04-06T13:48:47+02:00;Paris
Nationale - Vincent Auriol;33;28;5;0;5;2023-04-06T13:47:51+02:00;Paris
Charles de Gaulle - Plateau de Vanves;33;29;3;1;2;2023-04-06T13:45:57+02:00;Malakoff
Etienne Marcel - Montorgueil;28;17;11;6;5;2023-04-06T13:47:09+02:00;Paris
Lacuée - Lyon;16;0;14;9;5;2023-04-06T13:47:19+02:00;Paris
Olivier de Serres - Leriche;25;21;3;1;2;2023-04-06T13:44:10+02:00;Paris
Archives - Rivoli;25;9;12;9;3;2023-04-06T13:48:38+02:00;Paris
Sainte-Elisabeth - Turbigo;33;6;22;13;9;2023-04-06T13:48:11+02:00;Paris
Joffre - Aigle;20;15;4;1;3;2023-04-06T13:47:32+02:00;La Garenne-Colombes
Temple - Haudriettes;19;11;7;6;1;2023-04-06T13:45:23+02:00;Paris
Française - Etienne Marcel;37;25;7;2;5;2023-04-06T13:48:48+02:00;Paris
Blancs-Manteaux - Archives;29;9;16;10;6;2023-04-06T13:48:36+02:00;Paris
Saint-Michel - Luxembourg;29;17;9;7;2;2023-04-06T13:46:30+02:00;Paris
Hôtel de Ville d'Asnières sur Seine;30;18;8;5;3;2023-04-06T13:46:12+02:00;Asnières-sur-Seine
Montmartre - Etienne Marcel;16;4;11;8;3;2023-04-06T13:46:41+02:00;Paris
Square Emile - Chautemps;25;18;3;1;2;2023-04-06T13:47:18+02:00;Paris
Solitaires - Place des Fêtes;29;28;1;0;1;2023-04-06T13:46:14+02:00;Paris
Didot - Mariniers;35;35;0;0;0;2023-04-06T13:48:09+02:00;Paris
Cléry - Montmartre;44;8;34;17;17;2023-04-06T13:48:23+02:00;Paris
Lagny - Auguste Blanqui;27;1;25;9;16;2023-04-06T13:48:11+02:00;Montreuil
Adolphe Lalyre - Armand Silvestre;40;11;28;13;15;2023-04-06T13:48:11+02:00;Courbevoie
Gardenat-Lapostol - Velettes;20;20;0;0;0;2023-04-06T13:41:41+02:00;Suresnes
Bézout - Général Leclerc;30;27;3;0;3;2023-04-06T13:48:36+02:00;Paris
Place du 17 Octobre;20;4;14;12;2;2023-04-06T13:46:45+02:00;Gennevilliers
Hôtel de Ville de Chaville;20;17;2;1;1;2023-04-06T13:41:05+02:00;Chaville
Adolphe Pinard - Victor Hugo;52;52;0;0;0;2023-04-06T13:45:12+02:00;Malakoff
Gare d'Austerlitz - Pont Charles de Gaulle;55;0;53;31;22;2023-04-06T13:48:42+02:00;Paris
Kléber - National;20;11;6;1;5;2023-04-06T13:48:20+02:00;La Garenne-Colombes
Lally-Tollendal - Armand Carrel;28;25;2;1;1;2023-04-06T13:48:17+02:00;Paris
Mairie du 3ème;32;8;22;17;5;2023-04-06T13:48:04+02:00;Paris
Cours de Vincennes - Soult;45;32;13;8;5;2023-04-06T13:48:49+02:00;Paris
Convention - Lourmel;36;12;22;20;2;2023-04-06T13:48:23+02:00;Paris
Bastille - Beaumarchais;23;6;14;12;2;2023-04-06T13:47:57+02:00;Paris
Eugène Varlin - Place de la Paix;23;18;5;1;4;2023-04-06T13:46:40+02:00;Villejuif
Fille du Calvaire - Turenne;29;11;15;7;8;2023-04-06T13:49:06+02:00;Paris
Froidevaux - Boulard;35;31;4;1;3;2023-04-06T13:48:52+02:00;Paris
Château - République;20;7;11;5;6;2023-04-06T13:46:25+02:00;La Garenne-Colombes
Place de l'Hôtel de Ville;14;2;8;7;1;2023-04-06T13:49:02+02:00;Paris
Cesaria Evora - Rosa Parks;40;36;3;1;2;2023-04-06T13:42:00+02:00;Paris
Alouettes - Maréchal de Lattre de Tassigny;22;17;5;0;5;2023-04-06T13:46:34+02:00;Fontenay-sous-Bois
Victoire - Laffitte;20;6;12;10;2;2023-04-06T13:44:10+02:00;Paris
Jean Bleuzen - Square du 11 Novembre;49;48;1;0;1;2023-04-06T13:45:48+02:00;Vanves
Place de la Bastille - Bourdon;35;8;25;22;3;2023-04-06T13:48:54+02:00;Paris
Place de la République - Temple;18;12;6;6;0;2023-04-06T13:47:45+02:00;Paris
Tiron - Rivoli;28;4;22;12;10;2023-04-06T13:48:26+02:00;Paris
Séminaire de Conflans - Liberté;26;5;21;9;12;2023-04-06T13:48:37+02:00;Charenton-le-Pont
Verdier - Jean Jaurès;33;31;1;1;0;2023-04-06T13:47:45+02:00;Montrouge
Barbès - Monique Maunoury;40;37;2;1;1;2023-04-06T13:47:42+02:00;Ivry-sur-Seine
Mairie du Kremlin-Bicêtre;25;24;1;1;0;2023-04-06T13:49:02+02:00;Le Kremlin-Bicêtre
Porte de Saint Cloud - Parc des Princes;32;7;24;20;4;2023-04-06T13:48:19+02:00;Paris
Rivoli - Musée du Louvre;24;2;20;9;11;2023-04-06T13:48:22+02:00;Paris
Gare du Nord - La Chapelle;18;14;3;0;3;2023-04-06T13:42:26+02:00;Paris
Village Saint-Paul;28;8;19;9;10;2023-04-06T13:47:27+02:00;Paris
Gardenat Lapostol - Franklin Roosevelt;24;21;3;0;3;2023-04-06T13:43:01+02:00;Suresnes
Quai Jules Guesde - Saint-Simon;30;14;15;13;2;2023-04-06T13:49:05+02:00;Vitry-sur-Seine
Place Paul Delouvrier;26;20;4;4;0;2023-04-06T13:48:18+02:00;Paris
Bas - Gabriel Péri;30;26;1;0;1;2023-04-06T13:47:57+02:00;Asnières-sur-Seine
Candale - Mehul;25;23;2;1;1;2023-04-06T13:43:47+02:00;Pantin
Choiseul - Quatre Septembre;44;15;29;14;15;2023-04-06T13:48:39+02:00;Paris
Alger - Rivoli;21;0;20;8;12;2023-04-06T13:47:24+02:00;Paris
Mairie du 4ème;44;12;25;20;5;2023-04-06T13:49:02+02:00;Paris
Édouard Vaillant - Place Jean Jaurès;24;18;5;0;5;2023-04-06T13:49:02+02:00;Suresnes
Hippodrome Paris-Vincennes;42;36;6;2;4;2023-04-06T13:48:58+02:00;Paris
Aboukir - Alexandrie;21;12;7;5;2;2023-04-06T13:45:04+02:00;Paris
Saint-Gilles - Turenne;18;1;14;7;7;2023-04-06T13:48:14+02:00;Paris
Oratoire - Rivoli;18;0;18;9;9;2023-04-06T13:47:47+02:00;Paris
Poulet - Barbès;0;0;0;0;0;2019-03-20T15:46:36+01:00;Paris
Château - Place de Catalogne;33;32;1;0;1;2023-04-06T13:43:18+02:00;Paris
Pau Casals - Neuve Tolbiac;53;11;42;23;19;2023-04-06T13:48:43+02:00;Paris
Place du 8 mai 1945;30;13;14;7;7;2023-04-06T13:40:07+02:00;Saint-Denis
Jean-Jacques Rousseau - Deux Ecus;22;5;15;7;8;2023-04-06T13:48:07+02:00;Paris
Place du Lieutenant Henri Karcher;30;3;26;21;5;2023-04-06T13:48:47+02:00;Paris
Square Pierre Lazareff;17;5;12;6;6;2023-04-06T13:47:46+02:00;Paris
Grande Rue - Europe;25;24;1;0;1;2023-04-06T13:44:32+02:00;Sèvres
Waldeck Rochet - Germaine Tillon;31;13;17;12;5;2023-04-06T13:40:03+02:00;Aubervilliers
Custine - Ramey;41;39;1;1;0;2023-04-06T13:43:27+02:00;Paris
Saint Pères - Saint Germain;22;22;0;0;0;2023-04-06T13:41:50+02:00;Paris
Saint-Bon - Rivoli;19;17;1;1;0;2023-04-06T13:48:30+02:00;Paris
Chaussée d'Antin - Haussmann;24;2;20;9;11;2023-04-06T13:48:29+02:00;Paris
Square Victor Basch;20;8;10;2;8;2023-04-06T13:47:33+02:00;Colombes
Gare des Vallées;20;9;5;2;3;2023-04-06T13:46:10+02:00;La Garenne-Colombes
Filles Saint-Thomas - Place de la Bourse;58;20;38;27;11;2023-04-06T13:48:59+02:00;Paris
Choisy - Malmaisons;25;22;3;1;2;2023-04-06T13:46:29+02:00;Paris
Saint-Honoré - 29 juillet;20;0;18;14;4;2023-04-06T13:48:53+02:00;Paris
Mairie du 2ème;28;1;26;17;9;2023-04-06T13:48:42+02:00;Paris
Jouffroy d'Abbans - Villiers;34;32;0;0;0;2023-04-06T13:48:39+02:00;Paris
Ventadour - Opéra;27;1;26;14;12;2023-04-06T13:48:38+02:00;Paris
Saint-Placide - Cherche Midi;66;31;33;17;16;2023-04-06T13:48:48+02:00;Paris
Berthier - Porte de Clichy;24;3;17;16;1;2023-04-06T13:49:03+02:00;Paris
Decrès - Alésia;0;0;0;0;0;2023-03-01T13:01:35+01:00;Paris
Stade Pershing;26;26;0;0;0;2023-02-10T14:22:59+01:00;Paris
Guy Môquet - Parvis Georges Marchais;30;23;7;1;6;2023-04-06T13:46:46+02:00;Villejuif
Saint-Amand - Labrouste;36;33;1;0;1;2023-04-06T13:48:46+02:00;Paris
Saint-Honoré - Musée du Louvre;22;22;0;0;0;2023-04-06T13:48:59+02:00;Paris
Fabre d'Eglantine - Place de la Nation;68;39;27;22;5;2023-04-06T13:49:07+02:00;Paris
Le Goff - Gay-Lussac;35;9;24;4;20;2023-04-06T13:48:55+02:00;Paris
Marx Dormoy - Château Sainte-Barbe;22;21;0;0;0;2023-04-06T13:39:43+02:00;Fontenay-aux-Roses
Jean Jaurès - Paul Lafargue;28;16;11;7;4;2023-04-06T13:47:42+02:00;Puteaux
Amédée Huon - Fort d'Ivry;31;14;15;1;14;2023-04-06T13:45:20+02:00;Ivry-sur-Seine
Quai de l'Aisne - Général Leclerc;27;10;14;6;8;2023-04-06T13:48:51+02:00;Pantin
Archives - Pastourelle;28;11;15;12;3;2023-04-06T13:46:58+02:00;Paris
Arthur Ranc - Hôpital Bichat;26;23;2;1;1;2023-04-06T13:39:31+02:00;Paris
Résistance - Parmentier;35;30;5;2;3;2023-04-06T13:46:13+02:00;Montreuil
Magenta - Chabrol;24;13;8;3;5;2023-04-06T13:48:34+02:00;Paris
Verdun - Carnot;28;23;4;0;4;2023-04-06T13:48:27+02:00;Ivry-sur-Seine
Suresnes - Muette à Neuilly;30;24;6;1;5;2023-04-06T13:48:43+02:00;Paris
Parc Floral du Bel Air;25;20;4;2;2;2023-04-06T13:48:51+02:00;Paris
Parc Départemental des Hautes-Bruyères;30;26;3;0;3;2023-04-06T13:47:50+02:00;Villejuif
Marseillaise - Grenade;0;0;0;0;0;2023-01-17T06:58:51+01:00;Paris
Victor Hugo - Gare;22;11;10;6;4;2023-04-06T13:48:30+02:00;Colombes
Place de la Division Leclerc;35;31;4;1;3;2023-04-06T13:44:27+02:00;Fontenay-aux-Roses
Bréa - Raspail;24;2;20;7;13;2023-04-06T13:47:39+02:00;Paris
Cardinal Lavigerie;46;30;14;10;4;2023-04-06T13:47:45+02:00;Paris
Henri Barbusse - Marcel Cachin;37;37;0;0;0;2023-01-18T11:56:20+01:00;Saint-Denis
Place du Palais Royal;67;66;1;1;0;2023-04-06T13:45:36+02:00;Paris
Réaumur - Montmartre;19;2;17;13;4;2023-04-06T13:47:57+02:00;Paris
Belfort - Victor Hugo;24;16;7;6;1;2023-04-06T13:39:21+02:00;Clichy
Belles Feuilles - Place de Mexico;23;19;4;0;4;2023-04-06T13:46:39+02:00;Paris
Saint-Marc - Feydeau;37;4;33;22;11;2023-04-06T13:49:07+02:00;Paris
André Theuriet - Blagis;30;11;17;13;4;2023-04-06T13:46:15+02:00;Bourg-la-Reine
Porte de Pantin.;33;24;8;7;1;2023-04-06T13:47:31+02:00;Paris
Lampes;43;30;11;9;2;2023-04-06T13:48:18+02:00;Ivry-sur-Seine
Les Halles - Saint-Eustache;32;1;29;17;12;2023-04-06T13:48:06+02:00;Paris
Jules Guesdes - Carnot;16;14;0;0;0;2023-04-06T13:44:37+02:00;Saint-Denis
Place André Malraux;19;10;7;7;0;2023-04-06T13:49:02+02:00;Paris
Place des Victoires;24;4;20;15;5;2023-04-06T13:47:23+02:00;Paris
Coquillière - Louvre;21;3;18;12;6;2023-04-06T13:48:04+02:00;Paris
Victor Massé - Jean-Baptiste Pigalle;18;17;1;0;1;2023-04-06T13:46:57+02:00;Paris
Place de l'Eglise - Vitry-sur-Seine;28;1;24;23;1;2023-04-06T13:48:53+02:00;Vitry-sur-Seine
Danielle Casanova - Opéra;20;2;14;9;5;2023-04-06T13:43:50+02:00;Paris
Sorbier - Gasnier-Guy;34;33;0;0;0;2023-04-06T13:47:35+02:00;Paris
Silly - Louis Blériot;23;11;11;10;1;2023-04-06T13:48:03+02:00;Boulogne-Billancourt
Simon Bolivar - Henri Turot;22;19;2;0;2;2023-04-06T13:42:12+02:00;Paris
Saint-Mande - Picpus;35;29;5;2;3;2023-04-06T13:44:51+02:00;Paris
Victor Hugo - Paul Eluard;32;12;20;19;1;2023-04-06T13:48:54+02:00;Charenton-le-Pont
Les Blagis;27;15;11;8;3;2023-04-06T13:41:35+02:00;Sceaux
Blanqui - Docteur Bauer;28;9;14;11;3;2023-04-06T13:46:43+02:00;Saint-Ouen-sur-Seine
Place du Moulin de Javel;45;9;42;21;21;2023-04-06T13:46:01+02:00;Paris
Quai de Sèvres - Manufacture Nationale;28;2;22;16;6;2023-04-06T13:47:56+02:00;Sèvres
Youri Gagarine - Commune de Paris;33;27;6;0;6;2023-04-06T13:41:34+02:00;Vitry-sur-Seine
Paganini - Davout;22;11;9;6;3;2023-04-06T13:48:13+02:00;Paris
Strasbourg - Saint-Denis;16;1;13;10;3;2023-04-06T13:47:46+02:00;Paris
Bagnolet - Place Saint-Blaise;28;27;1;1;0;2023-04-06T13:41:06+02:00;Paris
Stalingrad - Henri Luisette;26;24;2;0;2;2023-04-06T13:49:07+02:00;Villejuif
Gare RER - Maurice Grandcoing;37;4;31;28;3;2023-04-06T13:49:04+02:00;Ivry-sur-Seine
Gare de Robinson;30;24;6;5;1;2023-04-06T13:47:29+02:00;Sceaux
Dutot - Place Alleray;56;56;0;0;0;2023-04-06T13:40:29+02:00;Paris
Jouffroy d'Abbans - Malesherbes;27;14;9;5;4;2023-04-06T13:48:39+02:00;Paris
Jardin Modèle - Pierre Boudou;18;6;9;4;5;2023-04-06T13:48:30+02:00;Asnières-sur-Seine
Mariotte - Batignolles;20;20;0;0;0;2022-12-05T09:45:14+01:00;Paris
République - Louis Loucheur;37;10;27;13;14;2023-04-06T13:48:32+02:00;Champigny-sur-Marne
Vincent Auriol - Louise Weiss;22;1;20;14;6;2023-04-06T13:48:54+02:00;Paris
Henri Barbusse - Gabriel Péri;27;25;2;0;2;2023-04-06T13:44:12+02:00;Châtillon
Halle Freyssinet - Parvis Alan Turing;23;2;21;10;11;2023-04-06T13:48:07+02:00;Paris
Stéphanie Bouvard - Gambetta;0;0;0;0;0;2022-11-03T10:26:33+01:00;Ivry-sur-Seine
Bichat - Grange aux Belles;30;26;2;2;0;2023-04-06T13:49:05+02:00;Paris
André Mazet - Saint-André des Arts;55;28;24;10;14;2023-04-06T13:48:28+02:00;Paris
Gare de Chaville Rive Gauche;18;13;3;3;0;2023-04-06T13:44:13+02:00;Chaville
Saint-Fiacre - Poissonière;35;18;14;7;7;2023-04-06T13:48:57+02:00;Paris
Mûriers - Père Lachaise;20;19;0;0;0;2023-04-06T13:47:46+02:00;Paris
Béranger - Félix Faure;28;24;2;2;0;2023-04-06T13:49:06+02:00;Châtillon
Gobelins - Port-Royal;40;32;3;3;0;2023-04-06T13:48:39+02:00;Paris
Place du Maréchal de Lattre de Tassigny;27;11;14;11;3;2023-04-06T13:48:37+02:00;Vanves
Danielle Casanova - Ledru-Rollin;28;21;5;4;1;2023-04-06T13:49:05+02:00;Ivry-sur-Seine
Martyrs de Châteaubriant - Jean Grandel;38;31;6;5;1;2023-04-06T13:42:36+02:00;Argenteuil
Belleville -  Pré Saint-Gervais;21;21;0;0;0;2023-04-06T13:41:39+02:00;Paris
Ney - Porte de Montmartre;24;14;6;3;3;2023-04-06T13:48:58+02:00;Paris
Saint-Denis - Rivoli;43;13;29;20;9;2023-04-06T13:48:24+02:00;Paris
Place Charles de Gaulle;24;20;4;0;4;2023-04-06T13:49:06+02:00;Ville-d'Avray
Clef des Champs - Albert Dhalenne;28;5;20;13;7;2023-04-06T13:46:57+02:00;Saint-Ouen-sur-Seine
Porte de Versailles;28;7;17;15;2;2023-04-06T13:45:26+02:00;Paris
Carrefour Pleyel;36;6;47;26;21;2023-04-06T13:47:37+02:00;Saint-Denis
Bons Raisins - Voltaire;24;16;7;1;6;2023-04-06T13:47:50+02:00;Rueil-Malmaison
Madeleine Vionnet;34;3;50;14;36;2023-04-06T13:48:25+02:00;Aubervilliers
Mathis - Flandre;55;51;2;0;2;2023-04-06T13:45:09+02:00;Paris
Gare - Aristide Briand;29;3;25;19;6;2023-04-06T13:48:09+02:00;Issy-les-Moulineaux
Pierre Charron - Champs-Elysées;32;5;24;4;20;2023-04-06T13:46:59+02:00;Paris
Manin - Secrétan;20;17;1;0;1;2023-04-06T13:47:51+02:00;Paris
Paix - Verdun;35;25;9;3;6;2023-04-06T13:49:06+02:00;Courbevoie
Château de Vincennes;52;24;24;17;7;2023-04-06T13:48:51+02:00;Paris
Balzac - Champs Elysées;30;6;24;4;20;2023-04-06T13:48:46+02:00;Paris
Place Denfert-Rochereau;20;15;5;5;0;2023-04-06T13:43:54+02:00;Boulogne-Billancourt
Bobillot - Tolbiac;33;32;1;1;0;2023-04-06T13:39:24+02:00;Paris
Chevaleret - Louise Weiss;35;5;28;22;6;2023-04-06T13:48:09+02:00;Paris
Général Leclerc - Bièvre;25;13;12;6;6;2023-04-06T13:45:43+02:00;Bourg-la-Reine
Saint-Augustin;31;5;24;17;7;2023-04-06T13:47:30+02:00;Paris
Félix Faure - Convention;44;10;32;27;5;2023-04-06T13:48:34+02:00;Paris
Léon Frot - Charonne;19;16;2;1;1;2023-04-06T13:48:37+02:00;Paris
Place du Docteur Yersin;50;29;21;7;14;2023-04-06T13:47:52+02:00;Paris
Dom-Pérignon - Gravelle;50;44;5;4;1;2023-04-06T13:47:50+02:00;Paris
Duméril - Jeanne d'Arc;40;33;7;7;0;2023-04-06T13:46:17+02:00;Paris
Maxime Gorki - Paul Vaillant-Couturier;20;17;3;0;3;2023-04-06T13:46:12+02:00;Villejuif
Cambronne - Mademoiselle;67;50;16;16;0;2023-04-06T13:45:00+02:00;Paris
Francoeur - Caulaincourt;34;26;3;2;1;2023-04-06T13:45:51+02:00;Paris
Euryale Dehaynin - Loire;30;27;0;0;0;2023-04-06T13:48:36+02:00;Paris
Hôtel de Ville de Saint-Ouen;48;6;35;26;9;2023-04-06T13:48:13+02:00;Saint-Ouen-sur-Seine
Pyrénées - Cours de Vincennes;21;3;17;8;9;2023-04-06T13:47:06+02:00;Paris
Lecourbe - Convention;46;39;7;6;1;2023-04-06T13:48:47+02:00;Paris
Dôme - République;25;9;10;9;1;2023-04-06T13:44:47+02:00;Boulogne-Billancourt
Suffren - La Motte-Piquet;23;15;8;8;0;2023-04-06T13:46:32+02:00;Paris
Riquet - Marx Dormoy;29;21;6;1;5;2023-04-06T13:48:57+02:00;Paris
Taitbout - Châteaudun;39;11;27;21;6;2023-04-06T13:47:49+02:00;Paris
Franquet - Labrouste;37;36;1;1;0;2023-04-06T13:48:17+02:00;Paris
Place de la vache noire;25;22;2;0;2;2023-04-06T13:45:25+02:00;Arcueil
Hauteville - Bonne Nouvelle;17;9;7;3;4;2023-04-06T13:47:51+02:00;Paris
Gouthière - Poterne des Peupliers;33;18;13;9;4;2023-04-06T13:47:35+02:00;Paris
Roquette - Auguste Laurent;16;7;9;8;1;2023-04-06T13:48:17+02:00;Paris
Port Royal - Hôpital Cochin;23;17;3;2;1;2023-04-06T13:49:06+02:00;Paris
Place Charles Digeon;32;16;15;11;4;2023-04-06T13:48:42+02:00;Saint-Mandé
Gergovie - Alésia;36;32;4;3;1;2023-04-06T13:44:08+02:00;Paris
Place de la Nation - Taillebourg;47;39;8;8;0;2023-04-06T13:48:01+02:00;Paris
LCL Campus - Place Oscar Niemeyer;37;34;1;0;1;2023-04-06T13:47:52+02:00;Villejuif
Place Eustache Deschamps;20;9;11;10;1;2023-04-06T13:47:59+02:00;Cachan
Général De Gaulle - Vivien;22;19;3;1;2;2023-04-06T13:41:16+02:00;Saint-Mandé
Moscou - Edouard Vaillant;30;27;1;0;1;2023-04-06T13:43:34+02:00;Bobigny
Edith Cavell - Volta;33;25;7;0;7;2023-04-06T13:47:55+02:00;Courbevoie
Buzenval - Vignoles;17;17;0;0;0;2023-04-06T13:47:07+02:00;Paris
Hôtel de Ville de Vincennes;27;23;4;0;4;2023-04-06T13:49:04+02:00;Vincennes
Edouard Pailleron - Bouret;27;20;6;2;4;2023-04-06T13:47:26+02:00;Paris
Square des Amandiers;12;11;0;0;0;2023-04-06T13:47:45+02:00;Paris
Pierre Joseph Desault;19;13;4;4;0;2023-04-06T13:48:07+02:00;Paris
Hispano Suiza - Parc des Bruyères;30;8;20;18;2;2023-04-06T13:49:07+02:00;Bois-Colombes
Guillaume Tell - Parc Henri Barbusse;20;15;4;1;3;2023-04-06T13:47:46+02:00;Pantin
Dominique Pado - Croix Nivert;22;15;7;5;2;2023-04-06T13:43:12+02:00;Paris
Pyrénées - Charles Renouvier;29;26;2;1;1;2023-04-06T13:44:59+02:00;Paris
Jean de la Fontaine - Boulainvilliers;68;35;29;20;9;2023-04-06T13:46:52+02:00;Paris
Hector Malot - Daumesnil;54;1;52;51;1;2023-04-06T13:47:22+02:00;Paris
Marcadet - Ramey;21;18;2;2;0;2023-04-06T13:49:03+02:00;Paris
Bercy - Traversiére;30;3;25;20;5;2023-04-06T13:47:29+02:00;Paris
Charonne - Alexandre Dumas;35;32;2;1;1;2023-04-06T13:45:49+02:00;Paris
Gambetta - Tourelles;20;0;0;0;0;2023-04-05T11:51:12+02:00;Paris
René Coty - Place Denfert-Rochereau;36;33;2;0;2;2023-04-06T13:48:46+02:00;Paris
Olympiades;36;29;5;2;3;2023-04-06T13:47:54+02:00;Paris
Duhamel - André Gide;20;18;1;0;1;2023-04-06T13:44:52+02:00;Paris
Maine - Jean Zay;50;47;2;2;0;2023-04-06T13:46:59+02:00;Paris
Jean Jaurès - Place de la Libération;30;20;10;3;7;2023-04-06T13:45:15+02:00;Bobigny
Assas - Rennes;32;17;15;7;8;2023-04-06T13:48:51+02:00;Paris
Lavoisier - Missak Manouchian;18;14;4;2;2;2023-04-06T13:47:16+02:00;Rosny-sous-Bois
Tombe Issoire - René Coty;36;34;1;0;1;2023-04-06T13:47:39+02:00;Paris
Saint-Séverin - Saint-Michel;30;16;9;3;6;2023-04-06T13:49:06+02:00;Paris
Pereire - Saussure;32;31;1;0;1;2023-04-06T13:43:34+02:00;Paris
Place Aristide Briand;35;30;2;2;0;2023-04-06T13:49:08+02:00;Charenton-le-Pont
Siam - La Pompe;16;14;1;0;1;2023-04-06T13:49:04+02:00;Paris
Mairie de Bagnolet;28;28;0;0;0;2023-04-06T13:48:48+02:00;Bagnolet
George Sand - Jean de La Fontaine;29;10;17;15;2;2023-04-06T13:47:31+02:00;Paris
Marceau - Président Wilson;32;3;27;15;12;2023-04-06T13:46:30+02:00;Paris
Alexandre Dumas - Place de la Réunion;45;42;0;0;0;2023-04-06T13:48:02+02:00;Paris
Legendre - Nollet;30;26;3;2;1;2023-04-06T13:47:25+02:00;Paris
Bourdonnais - Tour Eiffel;60;17;37;37;0;2023-04-06T13:48:06+02:00;Paris
Pierre Brossolette - 12 Février 1934;25;24;1;0;1;2023-04-06T13:48:55+02:00;Malakoff
Porte de la Plaine;35;29;6;0;6;2023-04-06T13:45:35+02:00;Paris
Rome - Provence;30;14;15;7;8;2023-04-06T13:41:12+02:00;Paris
Marcel Pourtout - Édouard Manet;24;3;20;13;7;2023-04-06T13:45:52+02:00;Rueil-Malmaison
Quatre Vents - Carrefour de l'Odéon;37;7;29;11;18;2023-04-06T13:45:36+02:00;Paris
Sahel - Général Michel Bizot;33;23;8;4;4;2023-04-06T13:44:30+02:00;Paris
Bois de Vincennes - Polygone;51;38;12;7;5;2023-04-06T13:44:34+02:00;Paris
Ancienne Mairie - André Morizet;25;10;15;11;4;2023-04-06T13:47:02+02:00;Boulogne-Billancourt
Colonel Pierre Avia;29;8;19;9;10;2023-04-06T13:46:21+02:00;Paris
Montreuil - République;25;20;5;2;3;2023-04-06T13:48:12+02:00;Vincennes
Passy - Place du Costa Rica;33;25;7;4;3;2023-04-06T13:48:43+02:00;Paris
Constantine - Université;65;6;57;38;19;2023-04-06T13:48:41+02:00;Paris
Guillaume Bertrand - République;38;35;3;2;1;2023-04-06T13:49:05+02:00;Paris
Gabriel Péri - Place de la Libération;18;12;6;4;2;2023-04-06T13:48:15+02:00;Montrouge
Jean-Baptiste Charcot - Sainte-Geneviève;21;7;12;11;1;2023-04-06T13:44:36+02:00;Courbevoie
Guy Môquet - Compoint;36;35;1;1;0;2023-04-06T13:46:28+02:00;Paris
Regard - Rennes;46;27;19;13;6;2023-04-06T13:48:06+02:00;Paris
Rampal - Belleville;17;12;3;0;3;2023-04-06T13:48:44+02:00;Paris
Pasteur - Cotentin;33;27;5;1;4;2023-04-06T13:47:21+02:00;Paris
Championnet.;22;19;0;0;0;2023-04-06T13:48:13+02:00;Paris
Volontaires - Vaugirard;34;27;6;5;1;2023-04-06T13:47:41+02:00;Paris
Reynaldo Hahn - Lagny;19;9;10;8;2;2023-04-06T13:48:39+02:00;Paris
Victor Hugo - Bineau;25;13;12;10;2;2023-04-06T13:45:36+02:00;Neuilly-sur-Seine
Verdier - République;29;27;2;1;1;2023-04-06T13:47:17+02:00;Montrouge
Mairie du 20ème;27;26;1;1;0;2023-04-06T13:49:03+02:00;Paris
Louis Blanc - Aqueduc;37;26;8;1;7;2023-04-06T13:48:43+02:00;Paris
Fief - République;25;4;19;16;3;2023-04-06T13:48:57+02:00;Boulogne-Billancourt
Philippe-Auguste;48;41;7;2;5;2023-04-06T13:47:07+02:00;Paris
Dantzig - Lefebvre;33;32;1;1;0;2023-04-06T13:46:45+02:00;Paris
Arthur Auger - Jean Jaurès;26;25;1;0;1;2023-04-06T13:46:08+02:00;Montrouge
Porte de Charenton;67;37;30;21;9;2023-04-06T13:49:01+02:00;Paris
Marché d'Auteuil;32;7;22;17;5;2023-04-06T13:48:03+02:00;Paris
Colisée - Champs-Elysées;24;2;17;8;9;2023-04-06T13:45:09+02:00;Paris
Ménilmontant - Oberkampf;40;36;3;0;3;2023-04-06T13:43:09+02:00;Paris
Bobillot - Moulin des Prés;28;22;5;1;4;2023-04-06T13:46:35+02:00;Paris
Lorraine - Jean Jaurès;19;18;1;1;0;2023-04-06T13:47:04+02:00;Paris
Jean Bologne - Passy;19;18;0;0;0;2023-04-06T13:46:44+02:00;Paris
M.- A. Lagroua Weill-Hallé -  F. Dolto;60;28;32;15;17;2023-04-06T13:48:28+02:00;Paris
Place d'Italie - Soeur Rosalie;52;52;0;0;0;2023-04-06T13:44:45+02:00;Paris
Hôtel de Ville de Rueil-Malmaison;20;13;5;1;4;2023-04-06T13:45:07+02:00;Rueil-Malmaison
Montparnasse -  Square Ozanam;49;49;0;0;0;2023-04-06T13:46:14+02:00;Paris
Arsonval - Falguière;25;22;3;2;1;2023-04-06T13:43:43+02:00;Paris
Rond-Point Rhin et Danube;53;31;22;18;4;2023-04-06T13:48:08+02:00;Boulogne-Billancourt
Crimée - Ourcq;56;50;3;2;1;2023-04-06T13:43:23+02:00;Paris
Geoffroy-Saint-Hilaire - Saint-Marcel;17;12;5;4;1;2023-04-06T13:46:17+02:00;Paris
Pyrénées - Dagorno;20;20;0;0;0;2023-04-06T13:44:14+02:00;Paris
Place Saint-André des Arts;37;23;13;5;8;2023-04-06T13:48:31+02:00;Paris
Jacquier - Didot;30;30;0;0;0;2023-04-06T13:45:10+02:00;Paris
Bertrand Sincholle - Henri Barbusse;23;14;5;3;2;2023-04-06T13:48:42+02:00;Clichy
Flandre - Ourcq;30;25;4;3;1;2023-04-06T13:42:06+02:00;Paris
Saint-Maur - République;38;35;3;3;0;2023-04-06T13:47:12+02:00;Paris
Point du Jour - Jean Jaurès;26;12;13;11;2;2023-04-06T13:48:51+02:00;Boulogne-Billancourt
Général Michel Bizot - Claude Decaen;38;22;12;9;3;2023-04-06T13:43:19+02:00;Paris
Saint-Marcel - Hôpital;21;12;8;6;2;2023-04-06T13:46:58+02:00;Paris
Ivry - Baudricourt;20;17;1;1;0;2023-04-06T13:41:56+02:00;Paris
Metz - Marne;33;29;1;1;0;2023-04-06T13:48:36+02:00;Paris
Lacépède - Linné;54;32;22;13;9;2023-04-06T13:48:27+02:00;Paris
Marcel Monge - Marcel Dassault;46;26;17;9;8;2023-04-06T13:47:41+02:00;Suresnes
Saint-Mandé - Docteur Arnold Netter;39;37;2;0;2;2023-04-06T13:48:17+02:00;Paris
Commandant Charcot - Bretteville;36;11;22;16;6;2023-04-06T13:48:52+02:00;Neuilly-sur-Seine
Etienne Dolet - Place Maurice Chevalier;33;33;0;0;0;2023-04-06T13:46:07+02:00;Paris
Guynemer - Jardin du Luxembourg;36;6;28;16;12;2023-04-06T13:45:38+02:00;Paris
Temple - Jean-Pierre Timbaud;36;23;10;5;5;2023-04-06T13:48:12+02:00;Paris
Verdun - Pierre et Marie Curie;26;22;3;2;1;2023-04-06T13:49:04+02:00;Ivry-sur-Seine
Convention - Campus de Bobigny;32;12;16;7;9;2023-04-06T13:49:05+02:00;Bobigny
Paul Valery - Victor Hugo;35;21;13;2;11;2023-04-06T13:47:34+02:00;Paris
Alfred de Vigny - Place du Général Brocard;33;14;17;6;11;2023-04-06T13:48:52+02:00;Paris
Pablo Picasso - Maurice Thorez;28;19;9;2;7;2023-04-06T13:48:34+02:00;Bobigny
Place des Arts - Jean Mermoz;20;20;0;0;0;2022-12-07T08:57:34+01:00;Rueil-Malmaison
Place Tristan Bernard;28;14;13;7;6;2023-04-06T13:48:42+02:00;Paris
Sèvres - Maréchal Juin;18;2;15;14;1;2023-04-06T13:47:40+02:00;Boulogne-Billancourt
Perrault - Place du Louvre;28;4;18;12;6;2023-04-06T13:48:34+02:00;Paris
Charles de Gaulle - Rue de l'Alma;28;25;2;1;1;2023-04-06T13:42:43+02:00;Courbevoie
Fontaine du Tertre - Calvaire;24;17;7;3;4;2023-04-06T13:48:46+02:00;Suresnes
René Boulanger - Lancry;62;54;6;4;2;2023-04-06T13:49:04+02:00;Paris
Port - Maurice Chevalier;30;30;0;0;0;2022-10-24T10:57:47+02:00;Nogent-sur-Marne
Gare du Nord - Faubourg Saint-Denis;28;19;7;3;4;2023-04-06T13:47:52+02:00;Paris
Résistance - Romain Rolland;28;24;3;0;3;2023-04-06T13:41:45+02:00;Argenteuil
Pyrénées - Ménilmontant;26;22;3;0;3;2023-04-06T13:49:07+02:00;Paris
Claude Debussy - Marc Bloch;56;14;41;34;7;2023-04-06T13:46:32+02:00;Clichy
Cité de la Musique;60;33;23;16;7;2023-04-06T13:47:12+02:00;Paris
Place Jean Mermoz;30;12;18;15;3;2023-04-06T13:43:35+02:00;Bois-Colombes
Georges Pompidou - Verdun;26;5;21;16;5;2023-04-06T13:45:31+02:00;Suresnes
Batignolles - Abel Truchet;28;24;3;2;1;2023-04-06T13:48:05+02:00;Paris
Musée d'Orsay;65;0;63;36;27;2023-04-06T13:48:56+02:00;Paris
Jean Mermoz - Champs-Elysées;33;1;30;20;10;2023-04-06T13:48:53+02:00;Paris
Félix Faure - Lourmel;58;13;44;44;0;2023-04-06T13:48:44+02:00;Paris
Ménilmontant - Père Lachaise;56;50;4;0;4;2023-04-06T13:48:17+02:00;Paris
Gambetta - Saint Fargeau;24;23;1;1;0;2023-04-06T13:49:01+02:00;Paris
Gare du Nord - Dunkerque;29;24;2;0;2;2023-04-06T13:48:02+02:00;Paris
Saint-Antoine Sévigné;26;0;32;23;9;2023-04-06T13:48:47+02:00;Paris
Gare RER les Ardoines;49;32;17;12;5;2023-04-06T13:49:08+02:00;Vitry-sur-Seine
Macdonald - Césaria Evora;67;60;7;7;0;2023-04-06T13:48:26+02:00;Paris
Paul Doumer - Stalingrad;24;18;6;3;3;2023-04-06T13:46:58+02:00;Arcueil
Pavé des Gardes - Charles Vaillant;20;18;2;0;2;2023-04-06T13:47:03+02:00;Sèvres
Hippodrome de Longchamp;30;5;18;13;5;2023-04-06T13:47:03+02:00;Paris
Gare RER - Général de Gaulle;41;4;35;24;11;2023-04-06T13:49:05+02:00;Gennevilliers
Payenne - Square George Caïn;24;9;12;11;1;2023-04-06T13:47:01+02:00;Paris
Chevaleret - Tolbiac;21;6;15;11;4;2023-04-06T13:48:21+02:00;Paris
8 Mai 1945 - 10 Juillet 1940;30;3;23;18;5;2023-04-06T13:47:35+02:00;Vitry-sur-Seine
Louis Armand - Bernard Palissy;0;0;0;0;0;2023-01-25T15:17:38+01:00;Asnières-sur-Seine
Galilée - Vernet;17;2;14;3;11;2023-04-06T13:47:42+02:00;Paris
Ménil - Argenteuil;20;5;14;10;4;2023-04-06T13:47:52+02:00;Asnières-sur-Seine
Enfants du Paradis - Peupliers;40;1;52;16;36;2023-04-06T13:48:38+02:00;Boulogne-Billancourt
Jean Bouin - Gouverneur Général Eboué;0;0;0;0;0;2023-04-03T08:03:51+02:00;Issy-les-Moulineaux
Saint-Lazare - Place d'Estienne d'Orves;39;17;11;3;8;2023-04-06T13:46:38+02:00;Paris
Stalingrad - Barbara;0;0;0;0;0;2023-03-29T12:26:44+02:00;Bagneux
Nungesser - Santé;22;19;2;1;1;2023-04-06T13:49:06+02:00;Fontenay-sous-Bois
Lamarck - Saint-Ouen;40;38;1;0;1;2023-04-06T13:48:25+02:00;Paris
Dora Maar - Nadia Guendouz;30;18;9;8;1;2023-04-06T13:47:49+02:00;Saint-Ouen-sur-Seine
Richard Lenoir - Place de la Bastille;53;22;24;20;4;2023-04-06T13:48:14+02:00;Paris
Epi d'Or - Chevilly;0;0;0;0;0;2023-03-30T08:59:02+02:00;Villejuif
Verdun - Henri Barbusse;24;20;4;2;2;2023-04-06T13:39:50+02:00;Bagneux
Stalingrad - Général de Gaulle;26;3;22;18;4;2023-04-06T13:45:08+02:00;Champigny-sur-Marne
Gare Saint-Lazare - Cour du Havre;45;16;25;8;17;2023-04-06T13:48:43+02:00;Paris
Maréchal Leclerc de Hauteclocque - Marché Buzenval;30;28;2;1;1;2023-04-06T13:40:14+02:00;Rueil-Malmaison
Quai des Célestins - Henri IV;14;3;8;5;3;2023-04-06T13:45:34+02:00;Paris
Cartier Bresson - Denis Papin;32;26;4;0;4;2023-04-06T13:49:08+02:00;Pantin
Saint-Germain - Verdun;30;30;0;0;0;2023-02-07T15:46:08+01:00;Romainville
Bercy - Villot;34;5;45;29;16;2023-04-06T13:46:36+02:00;Paris
Bastille - Biscornet;62;0;58;47;11;2023-04-06T13:48:54+02:00;Paris
Carpeaux - Place Jacques Froment;19;18;1;0;1;2023-04-06T13:40:15+02:00;Paris
Champs de Manoeuvre - Cartoucherie;20;9;10;2;8;2023-04-06T13:47:40+02:00;Paris
Jemmapes - Ecluses Saint-Martin;15;10;1;0;1;2023-04-06T13:46:28+02:00;Paris
Gare de Lyon - Roland Barthes;68;4;62;54;8;2023-04-06T13:47:05+02:00;Paris
Président Roosevelt - Rouget de Lisle;0;0;0;0;0;2021-07-28T09:10:05+02:00;Issy-les-Moulineaux
Guy Môquet - Jean Moulin;30;16;10;10;0;2023-04-06T13:47:12+02:00;Saint-Denis
Jean Jaurès - Place du Dr Roux;35;17;17;13;4;2023-04-06T13:44:36+02:00;Gennevilliers
Avenir;45;45;0;0;0;2023-04-06T13:45:53+02:00;Châtillon
Pierre Ginier - Clichy;16;12;3;3;0;2023-04-06T13:47:50+02:00;Paris
Division Leclerc - Kléber;25;20;5;0;5;2023-04-06T13:40:38+02:00;Châtillon
Châteaudun - Place de la Liberté;26;14;10;9;1;2023-04-06T13:49:05+02:00;La Garenne-Colombes
Place Balard;22;1;26;23;3;2023-04-06T13:46:54+02:00;Paris
Val-Fleury;23;20;0;0;0;2023-04-06T13:47:08+02:00;Meudon
Hélène et François Missoffe - Emile Borel;32;18;12;8;4;2023-04-06T13:48:10+02:00;Paris
Place du Colonel Fabien;27;24;2;0;2;2023-04-06T13:47:50+02:00;Paris
Adrien Lesesne - Docteur Bauer;30;22;8;5;3;2023-04-06T13:44:39+02:00;Saint-Ouen-sur-Seine
Faubourg St-Antoine - Place de la Nation;16;8;7;5;2;2023-04-06T13:44:17+02:00;Paris
Henri Barbusse - Bourguignons;34;26;8;7;1;2023-04-06T13:44:17+02:00;Asnières-sur-Seine
Charles de Gaulle - Madrid;22;5;17;9;8;2023-04-06T13:47:47+02:00;Neuilly-sur-Seine
Bateliers - Quai de Seine;26;11;13;7;6;2023-04-06T13:47:08+02:00;Saint-Ouen-sur-Seine
Parc des Pierrettes;23;22;0;0;0;2023-04-06T13:46:46+02:00;Châtillon
Roland Garros - Jean Bouin;28;27;0;0;0;2023-04-06T13:49:06+02:00;Châtillon
Place Henri Dunant - Gare RER;31;22;8;5;3;2023-04-06T13:48:36+02:00;Fontenay-aux-Roses
Gare RER;30;13;16;4;12;2023-04-06T13:47:27+02:00;Noisy-le-Sec
Gare Saint-Lazare - Place de Budapest;44;12;31;16;15;2023-04-06T13:47:56+02:00;Paris
Simone Signoret - Paris;28;13;14;14;0;2023-04-06T13:48:16+02:00;Noisy-le-Sec
Porte de Clichy - Place des Nations Unies;40;20;17;12;5;2023-04-06T13:48:57+02:00;Paris
Caumartin - Provence;22;14;10;3;7;2023-04-06T13:46:45+02:00;Paris
Marceau Delorme - Pierre Brossolette;28;12;9;7;2;2023-04-06T13:48:08+02:00;Asnières-sur-Seine
BNF - Bibliothèque Nationale de France;42;3;41;29;12;2023-04-06T13:48:37+02:00;Paris
Garibaldi - Gabriel Péri;30;10;18;12;6;2023-04-06T13:47:23+02:00;Saint-Ouen-sur-Seine
Jonquière - Docteur Paul Brousse;40;23;10;7;3;2023-04-06T13:40:48+02:00;Paris
Aristide Briand - Place de la Résistance;25;7;21;19;2;2023-04-06T13:49:02+02:00;Issy-les-Moulineaux
Ruisseau - Ordener;35;29;2;0;2;2023-04-06T13:43:30+02:00;Paris
Place de la Paix - Abbé Saint-Pierre;24;20;3;0;3;2023-04-06T13:48:37+02:00;Suresnes
Malesherbes - Place de la Madeleine;67;4;70;28;42;2023-04-06T13:48:49+02:00;Paris
Sebastopol - Rambuteau;16;13;2;1;1;2023-04-06T13:44:42+02:00;Paris
Gare de l'Est - Chateau Landon;59;53;4;2;2;2023-04-06T13:48:48+02:00;Paris
Ordener - Poissonniers;35;31;2;0;2;2023-04-06T13:48:00+02:00;Paris
Clignancourt - Ordener;35;32;3;3;0;2023-04-06T13:44:22+02:00;Paris
Westermeyer - Paul Vaillant-Couturier;25;4;30;21;9;2023-04-06T13:47:13+02:00;Ivry-sur-Seine
Benjamin Godard - Victor Hugo;35;30;5;2;3;2023-04-05T22:46:47+02:00;Paris
Mairie de Rosny-sous-Bois;30;22;7;1;6;2023-04-05T22:42:58+02:00;Rosny-sous-Bois
Mairie du 12ème;30;1;24;21;3;2023-04-05T22:46:54+02:00;Paris
Toudouze - Clauzel;21;10;11;8;3;2023-04-05T22:44:40+02:00;Paris
Rouget de L'isle - Watteau;0;0;0;0;0;2023-02-09T10:35:37+01:00;Vitry-sur-Seine
Jourdan - Stade Charléty;60;51;8;3;5;2023-04-05T22:42:52+02:00;Paris
Cassini - Denfert-Rochereau;25;25;0;0;0;2023-04-05T22:38:41+02:00;Paris
Basilique;22;15;3;1;2;2023-04-05T22:46:24+02:00;Saint-Denis
Charonne - Robert et Sonia Delaunay;20;11;9;4;5;2023-04-05T22:45:15+02:00;Paris
Messine - Place Du Pérou;12;11;0;0;0;2023-04-05T22:41:50+02:00;Paris
Saint-Sulpice;21;19;1;0;1;2023-04-05T22:47:11+02:00;Paris
Harpe - Saint-Germain;45;42;2;1;1;2023-04-05T22:45:31+02:00;Paris
Le Brun - Gobelins;48;32;15;10;5;2023-04-05T22:46:38+02:00;Paris
Lacépède - Monge;23;19;3;2;1;2023-04-05T22:40:42+02:00;Paris
Jean Rostand - Paul Vaillant Couturier;0;0;0;0;0;2023-04-05T11:45:11+02:00;Bobigny
Saint-Romain - Cherche-Midi;17;10;4;3;1;2023-04-05T22:47:15+02:00;Paris
Pierre et Marie Curie - Maurice Thorez;27;19;8;0;8;2023-04-05T22:47:14+02:00;Ivry-sur-Seine
André Karman - République;31;12;19;8;11;2023-04-05T22:42:38+02:00;Aubervilliers
Beaux-Arts - Bonaparte;20;17;1;0;1;2023-04-05T22:45:28+02:00;Paris
Bois de Vincennes - Gare;50;24;23;20;3;2023-04-05T22:45:51+02:00;Nogent-sur-Marne
Place Nelson Mandela;22;17;2;0;2;2023-04-05T22:39:18+02:00;Rueil-Malmaison
Silly - Galliéni;25;7;18;16;2;2023-04-05T22:46:13+02:00;Boulogne-Billancourt
Square Boucicaut;60;55;3;2;1;2023-04-05T22:45:27+02:00;Paris
Grande Armée - Brunel;62;53;5;2;3;2023-04-05T22:46:47+02:00;Paris
Vaneau - Sèvres;35;26;7;6;1;2023-04-05T22:46:29+02:00;Paris
Bracion - Périphérique;30;28;2;0;2;2023-04-05T22:46:15+02:00;Paris
Guersant - Gouvion-Saint-Cyr;36;25;10;8;2;2023-04-05T22:44:47+02:00;Paris
Thouin - Cardinal Lemoine;17;16;1;1;0;2023-04-05T22:47:14+02:00;Paris
Jouffroy d'Abbans - Wagram;40;12;10;10;0;2023-04-05T22:46:54+02:00;Paris
Romainville - Vaillant-Couturier;38;16;22;4;18;2023-04-05T22:46:05+02:00;Montreuil
Froment - Bréguet;43;12;24;19;5;2023-04-05T22:45:14+02:00;Paris
Bir Hakeim;33;10;23;21;2;2023-04-05T22:47:02+02:00;Paris
Morillons - Dantzig;52;39;13;7;6;2023-04-05T22:46:27+02:00;Paris
Liberté - Vert-de-Maisons;20;7;12;9;3;2023-04-05T22:45:54+02:00;Maisons-Alfort
Boétie - Ponthieu;33;30;1;0;1;2023-04-05T22:37:41+02:00;Paris
Lagny - Victor Basch;26;21;4;0;4;2023-04-05T22:45:44+02:00;Vincennes
Croulebarde - Corvisart;34;20;14;13;1;2023-04-05T22:47:01+02:00;Paris
Saint-Cloud - Hippodrome;30;24;6;2;4;2023-04-05T22:45:15+02:00;Paris
Le Brix et Mesmin - Jourdan;21;18;3;1;2;2023-04-05T22:46:26+02:00;Paris
Général Martial Valin - Pont du Garigliano;16;16;0;0;0;2023-04-05T22:44:48+02:00;Paris
Alibert - Jemmapes;60;4;54;54;0;2023-04-05T22:46:50+02:00;Paris
Rond-point du Dr Albert Schweitzer;22;12;10;1;9;2023-04-05T22:45:07+02:00;Bagneux
Porte de Saint-Ouen - Bessières;42;37;3;2;1;2023-04-05T22:46:40+02:00;Paris
Théâtre des Amandiers - Palais des sports;23;19;4;0;4;2023-04-05T22:44:01+02:00;Nanterre
Cambrai - Benjamin Constant;43;40;1;0;1;2023-04-05T22:43:52+02:00;Paris
Vaugirard - Monsieur le Prince;26;22;3;0;3;2023-04-05T22:46:53+02:00;Paris
Chazelles - Courcelles;35;25;6;3;3;2023-04-05T22:46:13+02:00;Paris
Serrurier;18;15;2;0;2;2023-04-05T22:37:31+02:00;Paris
Ramponeau - Belleville;44;22;19;15;4;2023-04-05T22:46:33+02:00;Paris
Jules Guesde - Pont du Port à l'Anglais;30;15;13;9;4;2023-04-05T22:40:34+02:00;Vitry-sur-Seine
Louis Lejeune - Barbès;25;21;4;0;4;2023-04-05T22:44:44+02:00;Montrouge
Michel-Ange - Parent de Rosan;26;6;19;9;10;2023-04-05T22:47:05+02:00;Paris
Raspail - Varenne;18;12;4;4;0;2023-04-05T22:46:22+02:00;Paris
Caire - Dussoubs;40;31;8;6;2;2023-04-05T22:45:50+02:00;Paris
Italie - Tolbiac;21;11;8;4;4;2023-04-05T22:47:03+02:00;Paris
Artois - Berri;23;21;1;0;1;2023-04-05T22:45:28+02:00;Paris
Raspail Barbès;28;27;0;0;0;2023-04-05T22:46:07+02:00;Montreuil
Marceau - Chaillot;21;20;1;0;1;2023-04-05T22:46:58+02:00;Paris
De Toqueville - Terrasse;30;26;3;1;2;2023-04-05T22:45:22+02:00;Paris
Regnault - Patay;63;34;26;25;1;2023-04-05T22:44:50+02:00;Paris
Tour d'Auvergne - Rodier;17;14;3;3;0;2023-04-05T22:46:28+02:00;Paris
Las Cases - Bourgogne;22;18;3;3;0;2023-04-05T22:46:00+02:00;Paris
Charlot - Stade Gabriel Voisin;0;0;0;0;0;2022-12-14T14:44:35+01:00;Issy-les-Moulineaux
Octave Feuillet - Albéric Magnard;21;18;3;2;1;2023-04-05T22:46:21+02:00;Paris
Liard - Amiral Mouchez;14;1;13;7;6;2023-04-05T22:47:06+02:00;Paris
Edgar Quinet - Raspail;46;32;14;2;12;2023-04-05T22:40:54+02:00;Paris
Félix Ziem - Armand Gauthier;25;7;15;5;10;2023-04-05T22:45:18+02:00;Paris
Faubourg Montmartre - La Fayette;35;25;8;6;2;2023-04-05T22:47:02+02:00;Paris
Abbeville - Faubourg Poissonnière;14;4;9;2;7;2023-04-05T22:43:54+02:00;Paris
Place Georges Guillaumin;29;24;1;1;0;2023-04-05T22:46:25+02:00;Paris
Youri Gagarine - Karl Marx;22;11;11;3;8;2023-04-05T22:44:52+02:00;Villejuif
Bellefond - Poissonnière;17;11;6;6;0;2023-04-05T22:47:12+02:00;Paris
Ney - Porte de Clignancourt;25;21;3;0;3;2023-04-05T22:42:56+02:00;Paris
Square Louis XVI;29;24;3;0;3;2023-04-05T22:45:31+02:00;Paris
Place Jean-Spire-Lemaître;50;16;34;19;15;2023-04-05T22:44:27+02:00;Vincennes
Alexandre Parodi - Quai de Valmy;24;23;0;0;0;2023-04-05T22:43:17+02:00;Paris
Jean Oestreicher - Porte de Champerret;21;19;2;0;2;2023-04-05T22:44:46+02:00;Paris
Ségur - d'Estrées;19;13;5;3;2;2023-04-05T22:38:43+02:00;Paris
Granges aux Belles;27;1;22;15;7;2023-04-05T22:46:43+02:00;Paris
Boudreau - Auber;14;12;1;1;0;2023-04-05T22:46:06+02:00;Paris
Dunkerque - Rocroy;24;19;3;1;2;2023-04-05T22:45:23+02:00;Paris
Verger - Colonel Guichard;29;22;7;2;5;2023-04-05T22:38:55+02:00;Issy-les-Moulineaux
Gay Lussac - Saint-Jacques;24;22;0;0;0;2023-04-05T22:45:34+02:00;Paris
Moulin de Pierre - Abbé Grégoire;0;0;0;0;0;2023-04-05T22:44:59+02:00;Issy-les-Moulineaux
Gare de l'Est - Faubourg-Saint-Martin;32;30;2;1;1;2023-04-05T22:40:24+02:00;Paris
Arsène Houssaye - Friedland;29;22;5;0;5;2023-04-05T22:47:16+02:00;Paris
Gare de Nogent-le-Perreux;32;9;20;17;3;2023-04-05T22:46:07+02:00;Nogent-sur-Marne
Pereire - Ternes;48;45;2;0;2;2023-04-05T22:45:35+02:00;Paris
Gabriel Lamé;36;3;32;31;1;2023-04-05T22:45:19+02:00;Paris
Gare Saint-Lazare - Isly;27;26;0;0;0;2023-04-05T22:40:55+02:00;Paris
Boulangers - Cardinal Lemoine;20;15;2;2;0;2023-04-05T22:45:57+02:00;Paris
Quai de l'Horloge - Pont Neuf;17;10;2;1;1;2023-04-05T22:45:44+02:00;Paris
Place de la République - Voltaire;19;12;5;5;0;2023-04-05T22:45:10+02:00;Paris
Porte Pouchet-Bessières;23;16;4;1;3;2023-04-05T22:41:32+02:00;Paris
Douai - Bruxelles;27;25;2;1;1;2023-04-05T22:46:39+02:00;Paris
Octave Gréard - Tour Eiffel;33;23;9;8;1;2023-04-05T22:46:13+02:00;Paris
Ambroise Rendu - Porte Brunet;17;11;6;1;5;2023-04-05T22:47:10+02:00;Paris
Institut du Monde Arabe - Saint-Germain;40;39;1;0;1;2023-04-05T22:46:53+02:00;Paris
Gare Rosny-Bois-Perrier;36;13;21;3;18;2023-04-05T22:47:13+02:00;Rosny-sous-Bois
Henri Barbusse - Stalingrad;16;9;6;0;6;2023-04-05T22:44:28+02:00;Malakoff
Institut de France;17;16;1;0;1;2023-04-05T22:45:46+02:00;Paris
Argenteuil - Voltaire;16;3;13;3;10;2023-04-05T22:47:14+02:00;Asnières-sur-Seine
Vigée-Lebrun - Anselme Payen;24;21;3;1;2;2023-04-05T22:47:10+02:00;Paris
Legendre - Clichy;40;18;20;15;5;2023-04-05T22:47:15+02:00;Paris
Château - République;26;24;2;0;2;2023-04-05T22:46:54+02:00;Bagnolet
Quai de la Seine;24;16;3;1;2;2023-04-05T22:46:37+02:00;Paris
Thionville - Ourcq;24;1;21;11;10;2023-04-05T22:47:08+02:00;Paris
Lisbonne - Monceau;33;31;1;1;0;2023-04-05T22:41:11+02:00;Paris
Rossini - Laffitte;33;32;0;0;0;2023-04-05T22:38:49+02:00;Paris
Chartres - La Charbonnière;34;27;6;3;3;2023-04-05T22:45:21+02:00;Paris
Gare de Lyon - Place Louis Armand;60;53;7;3;4;2023-04-05T22:47:13+02:00;Paris
Ranelagh - Mozart;23;12;10;7;3;2023-04-05T22:45:37+02:00;Paris
Pesaro - Préfecture;22;22;0;0;0;2023-04-05T22:06:06+02:00;Nanterre
Belidor - Gouvion-Saint-Cyr;39;37;1;0;1;2023-04-05T22:46:57+02:00;Paris
Moncey - Blanche;17;14;1;1;0;2023-04-05T22:46:59+02:00;Paris
Exelmans - Versailles;49;31;14;11;3;2023-04-05T22:44:04+02:00;Paris
Gare du Nord - Hôpital Lariboisière;49;41;7;2;5;2023-04-05T22:41:55+02:00;Paris
11 Novembre 1918 - 8 Mai 1945;36;12;24;8;16;2023-04-05T22:47:07+02:00;Champigny-sur-Marne
Place de Rhin et Danube;17;9;7;0;7;2023-04-05T22:46:36+02:00;Paris
Place Du Général De Gaulle;26;17;9;1;8;2023-04-05T22:43:55+02:00;Montreuil
Roquette - Thiéré;23;1;20;17;3;2023-04-05T22:45:57+02:00;Paris
Pereire - Rennequin;23;18;3;1;2;2023-04-05T22:46:09+02:00;Paris
Saint-Maur - Roquette;46;3;40;27;13;2023-04-05T22:46:15+02:00;Paris
Amelot - Saint-Sébastien;30;4;24;20;4;2023-04-05T22:47:00+02:00;Paris
Claude Decaen - Cannebière;27;14;13;3;10;2023-04-05T22:46:21+02:00;Paris
Panthéon - Valette;39;35;1;0;1;2023-04-05T22:43:01+02:00;Paris
Berri - Haussmann;35;34;0;0;0;2023-04-05T22:43:22+02:00;Paris
Cimetière de Montrouge;58;48;10;4;6;2023-04-05T22:45:38+02:00;Paris
Delphine Seyrig - Général Leclerc;53;51;2;1;1;2023-04-05T22:42:48+02:00;Pantin
Pyrénées - Emmery;40;28;10;0;10;2023-04-05T22:42:21+02:00;Paris
Desaix - Edgar Faure;12;1;10;10;0;2023-04-05T22:40:30+02:00;Paris
Redoute - Les Courtilles;32;2;27;15;12;2023-04-05T22:40:45+02:00;Asnières-sur-Seine
Gare RER - Canadiens;45;34;10;9;1;2023-04-05T22:45:07+02:00;Joinville-le-Pont
Saint-Ambroise - Parmentier;38;6;29;22;7;2023-04-05T22:46:07+02:00;Paris
Notre-Dame-des-Champs - Stanislas;19;16;2;0;2;2023-04-05T22:41:43+02:00;Paris
Pyramide - Ecole du Breuil;34;21;12;11;1;2023-04-05T22:42:17+02:00;Paris
Liège - Moscou;17;15;1;0;1;2023-04-05T22:47:13+02:00;Paris
Mairie de Montreuil;52;47;2;0;2;2023-04-05T22:46:56+02:00;Montreuil
Schoelcher - Raspail;50;40;9;5;4;2023-04-05T22:38:15+02:00;Paris
Square Simon Bolivar;24;19;4;1;3;2023-04-05T22:41:36+02:00;Paris
Rouget de Lisle;35;0;33;27;6;2023-04-05T22:43:55+02:00;Choisy-le-Roi
Cimetière de Montmartre;43;37;5;0;5;2023-04-05T22:38:39+02:00;Paris
Richard Lenoir - Republique;58;50;6;6;0;2023-04-05T22:46:27+02:00;Paris
Récollets - Square Villemin;17;14;2;1;1;2023-04-05T22:45:38+02:00;Paris
Port-Royal - Hôpital du Val-de-Grâce;18;3;14;5;9;2023-04-05T22:45:58+02:00;Paris
Charles de Gaulle - Beauté;49;40;8;3;5;2023-04-05T22:45:34+02:00;Nogent-sur-Marne
Grands Moulins de Pantin;50;45;4;1;3;2023-04-05T22:42:45+02:00;Paris
Marne - Germain Dardan;22;15;7;2;5;2023-04-05T22:42:14+02:00;Montrouge
Pajol - Place Herbert;39;0;38;18;20;2023-04-05T22:47:08+02:00;Paris
Mutualité;37;22;14;13;1;2023-04-05T22:46:54+02:00;Paris
Gabriel Péri - Francisco Ferrer;18;2;16;2;14;2023-04-05T22:40:13+02:00;Le Pré-Saint-Gervais
Anatole France - President Roosevelt;29;2;27;16;11;2023-04-05T22:46:05+02:00;Aubervilliers
Place de la Reine Astrid;58;52;1;0;1;2023-04-05T22:46:45+02:00;Paris
Henry Farman;16;16;0;0;0;2023-04-05T22:45:32+02:00;Paris
Roger Salengro - Fontainebleau;25;6;19;10;9;2023-04-05T22:46:32+02:00;Le Kremlin-Bicêtre
Jourdain - Place des Grandes Rigoles;22;22;0;0;0;2023-04-05T22:42:55+02:00;Paris
Concorde - Stalingrad;35;10;22;2;20;2023-04-05T22:46:30+02:00;Vitry-sur-Seine
Fontenay - Libération;25;0;24;13;11;2023-04-05T22:46:36+02:00;Vincennes
Carducci - Place Hannah Arendt;27;16;9;1;8;2023-04-05T22:46:29+02:00;Paris
Hôpital Européen Georges Pompidou;64;61;3;2;1;2023-04-05T22:46:57+02:00;Paris
Victor Hugo - Jeanne Jugan;28;21;4;3;1;2023-04-05T22:43:33+02:00;Paris
Fédération - Suffren;25;17;8;7;1;2023-04-05T22:47:08+02:00;Paris
Conservatoire de Musique;25;6;19;14;5;2023-04-05T22:45:26+02:00;Choisy-le-Roi
Saint-Jacques - Val de Grâce;20;12;5;3;2;2023-04-05T22:46:17+02:00;Paris
Cimetière de Fontenay-sous-Bois;15;13;2;0;2;2023-04-05T22:47:06+02:00;Fontenay-sous-Bois
Manin - Carrières d'Amérique;20;7;11;6;5;2023-04-05T22:40:10+02:00;Paris
Marc Sangnier - Porte de Vanves;21;17;2;0;2;2023-04-05T22:46:30+02:00;Paris
Porte de Vanves;32;31;1;1;0;2023-04-05T22:45:48+02:00;Paris
Etienne Jodelle - Saint Ouen;33;26;5;3;2;2023-04-05T22:45:07+02:00;Paris
Lucie Aubrac - Fort;30;20;8;1;7;2023-04-05T22:42:51+02:00;Issy-les-Moulineaux
Chabanais - Petits Champs;30;27;2;2;0;2023-04-05T22:40:14+02:00;Paris
Buisson Saint-Louis - Saint-Maur;19;13;5;4;1;2023-04-05T22:45:52+02:00;Paris
Bertie Albrecht - Hoche;32;29;1;0;1;2023-04-05T22:43:23+02:00;Paris
Place Albert Kahn;46;20;23;8;15;2023-04-05T22:44:53+02:00;Paris
Cevennes - Bergers;29;0;28;21;7;2023-04-05T22:45:51+02:00;Paris
Championnet - Vauvenargues;33;11;19;8;11;2023-04-05T22:46:50+02:00;Paris
Molière - République;30;16;14;5;9;2023-04-05T22:43:14+02:00;Montrouge
Place Marcel Cachin;32;2;29;27;2;2023-04-05T22:45:19+02:00;Ivry-sur-Seine
Hôtel de Ville de Boulogne Billancourt;26;2;19;16;3;2023-04-05T22:45:35+02:00;Boulogne-Billancourt
Rocher - Laborde;65;57;7;3;4;2023-04-05T22:44:00+02:00;Paris
Enghien - Faubourg Poissonnière;33;29;4;4;0;2023-04-05T22:39:41+02:00;Paris
Lecourbe - Jean Maridor;19;1;18;13;5;2023-04-05T22:46:57+02:00;Paris
David Weill - Parc Montsouris;22;14;6;2;4;2023-04-05T22:43:54+02:00;Paris
Grenelle - Violet;35;2;32;30;2;2023-04-05T22:45:41+02:00;Paris
Place Robert Guillemard;24;5;18;18;0;2023-04-05T22:45:49+02:00;Paris
Mouton Duvernet - Général Leclerc;39;37;2;0;2;2023-04-05T22:46:58+02:00;Paris
François Debergue - Croix de Chavaux;57;56;1;0;1;2023-04-05T22:46:00+02:00;Montreuil
Erasme - Ulm;24;23;0;0;0;2023-04-05T22:45:03+02:00;Paris
Nationale - Place Jules Guesde;23;1;19;18;1;2023-04-05T22:47:08+02:00;Boulogne-Billancourt
Guy Môquet - Etienne Dolet;23;17;5;1;4;2023-04-05T22:47:05+02:00;Malakoff
Gabriel Péri - Danielle Casanova;20;4;15;8;7;2023-04-05T22:45:45+02:00;Vitry-sur-Seine
Jean Jaurès - Presles;30;14;13;7;6;2023-04-05T22:44:28+02:00;Pantin
Lakanal - Commerce;53;3;46;45;1;2023-04-05T22:47:08+02:00;Paris
Boissière - Etienne Dolet;21;8;13;1;12;2023-04-05T22:41:06+02:00;Montreuil
Karl Marx;16;14;2;1;1;2023-04-05T22:39:32+02:00;Villejuif
Marcadet - Barbès;37;19;17;9;8;2023-04-05T22:45:52+02:00;Paris
Tertres - Fontaine;28;20;8;3;5;2023-04-05T22:43:52+02:00;Bagneux
Sibelle - Alésia;25;17;7;7;0;2023-04-05T22:44:12+02:00;Paris
Oberkampf - République;24;4;19;16;3;2023-04-05T22:46:25+02:00;Paris
Hoche - Jean Lolive;24;1;23;8;15;2023-04-05T22:43:57+02:00;Pantin
Cossonnerie - Sébastopol;24;23;0;0;0;2023-04-05T22:45:30+02:00;Paris
Saint Lambert - Blomet;27;0;26;17;9;2023-04-05T22:44:31+02:00;Paris
Noisy le Sec - Jean-Baptiste Clément;22;1;20;0;20;2023-04-05T22:46:46+02:00;Bagnolet
Marcelin Berthelot;27;6;20;15;5;2023-04-05T22:46:32+02:00;Boulogne-Billancourt
Cujas - Saint-Michel;19;14;1;0;1;2023-04-05T22:45:39+02:00;Paris
Repos - Cimetière du Père Lachaise;33;21;10;5;5;2023-04-05T22:46:39+02:00;Paris
Henri Ste-Claire Déville - Paul Héroult;24;11;10;8;2;2023-04-05T22:38:41+02:00;Rueil-Malmaison
Edouard Tremblay - Julian Grimaux;30;25;5;0;5;2023-04-05T22:43:27+02:00;Vitry-sur-Seine
Paris - Emile Zola;30;14;12;3;9;2023-04-05T22:46:57+02:00;Montreuil
Carnot - Pâquerettes;26;5;19;7;12;2023-04-05T22:44:55+02:00;Alfortville
Jean Jaurès - Salvador Allende;43;40;2;1;1;2023-04-05T22:47:01+02:00;Malakoff
Place de la Porte de Champerret;0;0;0;0;0;2023-02-17T00:20:23+01:00;Paris
Victoire - Chaussée d'Antin;24;22;1;0;1;2023-04-05T22:44:41+02:00;Paris
Gare Rer de Fontenay sous Bois;61;51;8;7;1;2023-04-05T22:46:32+02:00;Fontenay-sous-Bois
Galilée - Kléber;32;31;1;0;1;2023-04-05T22:47:10+02:00;Paris
Raspail - Manufacture des Oeillets;32;8;24;14;10;2023-04-05T22:46:20+02:00;Ivry-sur-Seine
Quai Panhard et Levassor;57;55;0;0;0;2023-04-05T22:44:06+02:00;Paris
Marcelle - Thalie;20;14;3;0;3;2023-04-05T22:37:39+02:00;Pantin
Chemin Vert - Saint-Maur;45;8;37;22;15;2023-04-05T22:46:00+02:00;Paris
Louis Lumière - Porte de Bagnolet;20;19;0;0;0;2023-04-05T22:43:51+02:00;Paris
Square du Théâtre du Garde-Chasse;50;43;6;1;5;2023-04-05T22:43:58+02:00;Les Lilas
Victor Hugo - Galliéni;34;5;29;25;4;2023-04-05T22:46:46+02:00;Boulogne-Billancourt
Botzaris - Parc des Buttes Chaumont;20;17;0;0;0;2023-04-05T22:42:49+02:00;Paris
Richard Lenoir - Jean-Pierre Timbaud;36;19;16;13;3;2023-04-05T22:46:25+02:00;Paris
Général De Gaulle - Alouette;26;1;24;17;7;2023-04-05T22:47:12+02:00;Saint-Mandé
Legendre - Dulong;23;17;4;3;1;2023-04-05T22:46:41+02:00;Paris
Joseph Liouville - Croix Nivert;64;43;21;9;12;2023-04-05T22:46:20+02:00;Paris
Rochechouart lamartine;24;2;21;20;1;2023-04-05T22:47:14+02:00;Paris
Place Madeleine Daniélou;42;36;6;2;4;2023-04-05T22:41:57+02:00;Paris
Estrapade - Ulm;16;14;1;0;1;2023-04-05T22:46:46+02:00;Paris
Cauchy - Cévennes;51;2;45;38;7;2023-04-05T22:46:58+02:00;Paris
Hoche - Tilsitt;33;33;0;0;0;2023-04-05T22:42:47+02:00;Paris
Beffroy;26;24;2;0;2;2023-04-05T22:41:55+02:00;Neuilly-sur-Seine
Jean-François Lépine - Stephenson;22;9;8;6;2;2023-04-05T22:47:11+02:00;Paris
Molitor - Chardon-Lagache;34;5;27;25;2;2023-04-05T22:44:41+02:00;Paris
Marie-Georges Picquart - Pereire;32;28;4;0;4;2023-04-05T22:43:56+02:00;Paris
Abbé Carton - Plantes;25;20;4;4;0;2023-04-05T22:46:48+02:00;Paris
Sablons - Georges Mandel;38;38;0;0;0;2023-04-05T22:45:02+02:00;Paris
Gare RER de Vincennes;51;48;1;0;1;2023-04-05T22:46:54+02:00;Vincennes
Mairie du 11ème;51;2;46;42;4;2023-04-05T22:45:45+02:00;Paris
Marché Secrétan;26;23;2;1;1;2023-04-05T22:45:23+02:00;Paris
Théophile Gautier - François Millet;30;3;24;24;0;2023-04-05T22:45:03+02:00;Paris
Lieutenant Chauré - Etienne Marey;20;18;2;0;2;2023-04-05T22:40:46+02:00;Paris
Villette - Belleville;48;15;29;21;8;2023-04-05T22:47:13+02:00;Paris
Parmentier - République;50;27;22;15;7;2023-04-05T22:43:43+02:00;Paris
Larmeroux - Baudelaire;29;12;16;4;12;2023-04-05T22:46:38+02:00;Vanves
Arche - Léonard de Vinci;28;26;1;0;1;2023-04-05T22:37:49+02:00;Courbevoie
Charles de Gaulle - Sablonville;26;18;7;3;4;2023-04-05T22:38:26+02:00;Neuilly-sur-Seine
Miromesnil - La Boétie;35;33;1;0;1;2023-04-05T22:45:54+02:00;Paris
Auguste Cain - Jean Moulin;40;33;7;2;5;2023-04-05T22:46:58+02:00;Paris
Chemin Vert - Fraternité;20;16;3;0;3;2023-04-05T22:45:40+02:00;Romainville
Marseille - Beaurepaire;55;37;15;15;0;2023-04-05T22:45:46+02:00;Paris
Saint-Germain - Thenard;31;18;9;9;0;2023-04-05T22:47:13+02:00;Paris
Arago - Glacière;27;13;14;9;5;2023-04-05T22:47:06+02:00;Paris
Parmentier - Abel Rabaud;52;27;22;16;6;2023-04-05T22:47:09+02:00;Paris
Place Paul Eluard;19;1;18;16;2;2023-04-05T22:45:52+02:00;Choisy-le-Roi
Mairie d'Ivry-sur-Seine;53;5;48;37;11;2023-04-05T22:46:32+02:00;Ivry-sur-Seine
Exelmans - Michel-Ange;33;27;4;1;3;2023-04-05T22:46:31+02:00;Paris
Parc Georges Brassens - Brancion;29;8;21;12;9;2023-04-05T22:44:49+02:00;Paris
Reims - Raymond Pitet;37;33;2;0;2;2023-04-05T22:43:50+02:00;Paris
Pierret - Madrid;28;26;1;1;0;2023-04-05T22:45:54+02:00;Neuilly-sur-Seine
Saint-Vincent - Verdun;34;5;26;16;10;2023-04-05T22:46:57+02:00;Issy-les-Moulineaux
Aristide Briand - Gare de Bagneux;22;20;2;0;2;2023-04-05T22:45:31+02:00;Cachan
Hautpoul - Jean Jaurès;32;12;17;4;13;2023-04-05T22:47:08+02:00;Paris
Victoria - Place du Chatelet;22;16;2;0;2;2023-04-05T22:47:01+02:00;Paris
Wilson - Métallurgie;28;18;9;5;4;2023-04-05T22:38:31+02:00;Saint-Denis
Seine - Flandre;19;6;13;10;3;2023-04-05T22:46:53+02:00;Paris
Madame de Sanzillon - Mozart;22;12;6;5;1;2023-04-05T22:40:51+02:00;Clichy
Mathurins - Auber;36;33;1;1;0;2023-04-05T22:39:51+02:00;Paris
Mairie du 7ème;27;24;1;1;0;2023-04-05T22:45:37+02:00;Paris
Grand Prieuré - Crussol;49;18;28;28;0;2023-04-05T22:46:39+02:00;Paris
Marignan - Champs-Elysées;35;33;1;0;1;2023-04-05T22:38:37+02:00;Paris
Square d'Anvers;33;18;14;7;7;2023-04-05T22:46:42+02:00;Paris
Gare RER de Gentilly;30;17;12;5;7;2023-04-05T22:41:34+02:00;Gentilly
Volontaire - Lecourbe;31;1;28;16;12;2023-04-05T22:46:22+02:00;Paris
Place de la Porte de Paris;40;22;16;6;10;2023-04-05T22:47:17+02:00;Saint-Denis
Laumière - Petit;34;6;25;17;8;2023-04-05T22:45:25+02:00;Paris
Place Amédée Gordini - Lefebvre;38;29;9;2;7;2023-04-05T22:47:04+02:00;Paris
Quai du docteur Dervaux;26;26;0;0;0;2023-01-18T09:46:16+01:00;Asnières-sur-Seine
Stalingrad - Désiré Chevalier;42;33;8;2;6;2023-04-05T22:44:08+02:00;Montreuil
Gare Arcueil - Cachan;26;21;4;1;3;2023-04-05T22:43:05+02:00;Arcueil
Hôtel de Ville de Nanterre;38;13;23;1;22;2023-04-05T22:47:13+02:00;Nanterre
Place Jean Ferrat;25;9;14;6;8;2023-04-05T22:46:46+02:00;Ivry-sur-Seine
Victor Hugo - Ecoles;25;8;17;11;6;2023-04-05T22:45:00+02:00;Alfortville
Villiers de l'Isle Adam - Pyrénées;20;3;16;0;16;2023-04-05T22:46:55+02:00;Paris
Charonne - Faubourg Saint-Antoine;34;3;27;26;1;2023-04-05T22:45:48+02:00;Paris
Saint-Jacques - Soufflot;0;0;0;0;0;2018-06-06T08:42:14+02:00;Paris
Jules Ferry - Faubourg du Temple Paris;58;27;28;23;5;2023-04-05T22:46:48+02:00;Paris
Flandre - Alphonse Karr;25;3;21;15;6;2023-04-05T22:45:21+02:00;Paris
Stephenson - Doudeauville;36;4;31;11;20;2023-04-05T22:46:58+02:00;Paris
Hôpital Bégin;26;22;3;2;1;2023-04-05T22:45:45+02:00;Vincennes
Charenton - Diderot;18;1;15;15;0;2023-04-05T22:44:42+02:00;Paris
Raspail - Bac;52;52;0;0;0;2023-04-05T22:46:01+02:00;Paris
Boulard - Daguerre;45;40;5;4;1;2023-04-05T22:44:54+02:00;Paris
Place de l'Édit de Nantes;30;17;12;11;1;2023-04-05T22:46:05+02:00;Paris
Tristan Tzara -  Tchaïkovski;33;6;24;8;16;2023-04-05T22:46:08+02:00;Paris
Saint Georges - d'Aumale;23;13;9;7;2;2023-04-05T22:46:13+02:00;Paris
Boyer - Ménilmontant;19;1;2;0;2;2023-03-13T01:29:37+01:00;Paris
Stalingrad - Germaine Tailleferre;28;17;11;4;7;2023-04-05T22:47:14+02:00;Ivry-sur-Seine
Anatole France - Louise Michel;50;43;4;4;0;2023-04-05T22:42:55+02:00;Levallois-Perret
Jacques Callot - Mazarine;28;17;6;5;1;2023-04-05T22:46:46+02:00;Paris
Montgallet - Charenton;16;1;11;10;1;2023-04-05T22:40:01+02:00;Paris
Flandre - Riquet;21;6;15;6;9;2023-04-05T22:45:35+02:00;Paris
Gaston Roussel - Commune de Paris;30;21;8;0;8;2023-04-05T22:46:11+02:00;Romainville
Jean Macé - Faidherbe;63;10;51;33;18;2023-04-05T22:43:07+02:00;Paris
Porte de Vincennes;33;31;2;2;0;2023-04-05T22:42:36+02:00;Paris
Dupleix - du Guesclin;47;18;28;28;0;2023-04-05T22:47:06+02:00;Paris
Bienfaisance - Place de Narvik;36;34;1;1;0;2023-04-05T22:45:45+02:00;Paris
Boulets - Voltaire;24;9;15;12;3;2023-04-05T22:45:47+02:00;Paris
Guynemer - Séverine;26;18;7;6;1;2023-04-05T22:39:52+02:00;Issy-les-Moulineaux
Pasteur - Gambetta;19;15;4;2;2;2023-04-05T22:46:51+02:00;Saint-Mandé
Richard Wallace - Place du 8 Mai 1945;30;9;21;15;6;2023-04-05T22:45:22+02:00;Puteaux
Fragonard - Porte de Clichy;56;17;34;33;1;2023-04-05T22:47:10+02:00;Paris
Square Gilbert Thomain;20;11;9;2;7;2023-04-05T22:46:39+02:00;Asnières-sur-Seine
Place des Ternes.;46;40;6;4;2;2023-04-05T22:46:39+02:00;Paris
Alfred Roll - Berthier;28;21;7;2;5;2023-04-05T22:45:41+02:00;Paris
Place de Verdun;40;1;39;31;8;2023-04-05T22:44:13+02:00;Joinville-le-Pont
Faustin Hélie - Desbordes-Valmore;33;27;3;1;2;2023-04-05T22:45:43+02:00;Paris
Montgallet - Reuilly;16;8;7;6;1;2023-04-05T22:45:09+02:00;Paris
Varenne;47;44;2;1;1;2023-04-05T22:41:54+02:00;Paris
Parmentier - Hôpital Saint-Louis;43;16;25;14;11;2023-04-05T22:45:35+02:00;Paris
Ancien Canal - Hélène Brion;23;9;14;1;13;2023-04-05T22:47:10+02:00;Pantin
Place Jacques Madaule;25;11;14;13;1;2023-04-05T22:41:14+02:00;Issy-les-Moulineaux
Departement - Pajol;19;2;16;8;8;2023-04-05T22:46:54+02:00;Paris
Jussieu - Fossés Saint-Bernard;39;27;12;9;3;2023-04-05T22:46:13+02:00;Paris
Edouard Poisson - Victor Hugo;30;3;27;20;7;2023-04-05T22:46:57+02:00;Aubervilliers
Jardin d'Acclimatation;33;30;2;1;1;2023-04-05T22:46:48+02:00;Paris
Montreuil - Gonnet;24;6;16;12;4;2023-04-05T22:45:03+02:00;Paris
Square Cambronne;59;59;0;0;0;2023-03-27T23:08:50+02:00;Paris
Place de la Porte de Châtillon;59;53;4;1;3;2023-04-05T22:40:18+02:00;Paris
Porte Maillot - Pereire;0;0;0;0;0;2022-07-25T00:02:50+02:00;Paris
Commandant Rivière;27;23;1;1;0;2023-04-05T22:42:51+02:00;Paris
Gare de Laplace;43;42;1;0;1;2023-04-05T22:45:09+02:00;Arcueil
Gare Montparnasse - René Mouchotte;39;39;0;0;0;2023-04-05T22:46:37+02:00;Paris
Clignancourt - Sofia;19;2;15;5;10;2023-04-05T22:46:19+02:00;Paris
Paul Vaillant Couturier - Chaptal;39;32;3;3;0;2023-04-05T22:43:43+02:00;Levallois-Perret
Alexandre Dumas - Voltaire;59;28;26;13;13;2023-04-05T22:47:05+02:00;Paris
Bayen - Pereire;22;10;10;10;0;2023-04-05T22:46:45+02:00;Paris
Bordier - Félix Faure;48;27;18;10;8;2023-04-05T22:46:50+02:00;Aubervilliers
Quai de la Loire - Jean Jaurès;16;12;1;1;0;2023-04-05T22:45:27+02:00;Paris
Félix Faure - Sadi Carnot;33;27;2;0;2;2023-04-05T22:44:22+02:00;Aubervilliers
Route de Sèvres - Porte de Bagatelle;66;6;56;56;0;2023-04-05T22:46:54+02:00;Paris
Jean Colly - Tolbiac;36;30;5;1;4;2023-04-05T22:47:08+02:00;Paris
Charonne - Avron;27;19;7;3;4;2023-04-05T22:46:39+02:00;Paris
Flandrin - Henri Martin;18;18;0;0;0;2023-04-05T22:42:38+02:00;Paris
18 juin 1940 - Buzenval;25;19;5;2;3;2023-04-05T22:37:36+02:00;Rueil-Malmaison
Pirogues de Bercy - Libourne;49;42;6;6;0;2023-04-05T22:46:02+02:00;Paris
Mairie de La Garenne Colombes;22;1;18;11;7;2023-04-05T22:43:41+02:00;La Garenne-Colombes
Gare de Courbevoie;35;27;6;4;2;2023-04-05T22:46:48+02:00;Courbevoie
Porte de la Villette;27;17;7;6;1;2023-04-05T22:47:02+02:00;Paris
Réunion - Avron;26;12;14;7;7;2023-04-05T22:46:36+02:00;Paris
Ouest - Château;23;22;1;1;0;2023-04-05T22:43:06+02:00;Paris
Square des Saint-Simoniens;25;16;8;1;7;2023-04-05T22:45:48+02:00;Paris
Place aux Étoiles;40;38;2;1;1;2023-04-05T22:43:49+02:00;Saint-Denis
Petit - Manin;22;12;10;1;9;2023-04-05T22:42:46+02:00;Paris
Assemblée Nationale;63;61;0;0;0;2023-04-05T22:44:03+02:00;Paris
Gare de Clamart;14;2;10;0;10;2023-04-05T22:47:08+02:00;Clamart
Place Violet;30;1;28;27;1;2023-04-05T22:44:13+02:00;Paris
Charenton - Wattignies;33;0;32;32;0;2023-04-05T22:46:07+02:00;Paris
Dugommier;55;5;47;34;13;2023-04-05T22:46:53+02:00;Paris
Ménilmontant - Pelleport;19;3;16;0;16;2023-04-05T22:44:51+02:00;Paris
Victor Hugo - Magasins Généraux;34;31;2;1;1;2023-04-05T22:46:45+02:00;Aubervilliers
Chanzy - Sud-Est;25;5;20;16;4;2023-04-05T22:46:50+02:00;Nanterre
Porte d'Auteuil;33;10;21;17;4;2023-04-05T22:46:26+02:00;Paris
Jussieu - Guy de la Brosse;40;35;4;2;2;2023-04-05T22:41:48+02:00;Paris
Place Jean-Baptiste Clément;25;6;18;8;10;2023-04-05T22:47:09+02:00;Le Kremlin-Bicêtre
Jean Lolive - Parc Stalingrad;22;14;8;2;6;2023-04-05T22:39:32+02:00;Pantin
Claude Bernard - Arbalète;17;5;12;10;2;2023-04-05T22:46:35+02:00;Paris
Parc Pierre Lagravère;30;6;22;14;8;2023-04-05T22:45:40+02:00;Colombes
Gare d'Austerlitz;14;8;3;2;1;2023-04-05T22:47:15+02:00;Paris
Guichet - Jean Jaurès;28;9;17;13;4;2023-04-05T22:45:51+02:00;Clichy
Place des Marseillais;37;28;6;3;3;2023-04-05T22:45:20+02:00;Charenton-le-Pont
Parvis Robert Schuman - Roger Salengro;24;20;4;0;4;2023-04-05T22:38:54+02:00;Chaville
Champeaux - Gallieni;50;45;4;0;4;2023-04-05T22:38:38+02:00;Bagnolet
Edgar Quinet - Gaité;27;27;0;0;0;2023-04-05T22:43:05+02:00;Paris
Courcelles - Place des Ternes;31;23;4;4;0;2023-04-05T22:46:39+02:00;Paris
Gravelle - Route du Bac;51;31;15;5;10;2023-04-05T22:44:53+02:00;Paris
Evariste Galois;30;23;4;0;4;2023-04-05T22:46:46+02:00;Paris
Gare de Bercy;35;20;14;12;2;2023-04-05T22:45:38+02:00;Paris
Navier - Epinettes;36;24;12;3;9;2023-04-05T22:46:31+02:00;Paris
Ceinture du Lac Inferieure - Saint-Cloud;42;41;0;0;0;2023-04-05T22:47:16+02:00;Paris
Verdun - Place Henri IV;26;13;12;7;5;2023-04-05T22:46:50+02:00;Suresnes
Lagny - Joffre;31;29;2;2;0;2023-04-05T22:47:15+02:00;Saint-Mandé
Place Carnot;25;4;20;8;12;2023-04-05T22:46:41+02:00;Montreuil
Place Falguière;23;6;17;6;11;2023-04-05T22:46:40+02:00;Paris
Anatole France - Jean Lolive;28;23;3;1;2;2023-04-05T22:43:41+02:00;Pantin
Tardieu - Chappe;18;15;1;0;1;2023-04-05T22:38:13+02:00;Paris
Boyer-Barret - Raymond Losserand;23;7;16;11;5;2023-04-05T22:37:41+02:00;Paris
Petites Ecuries - Faubourg Poissonnière;17;9;5;2;3;2023-04-05T22:47:15+02:00;Paris
Piat - Parc de Belleville;21;12;7;0;7;2023-04-05T22:44:34+02:00;Paris
Nanterre - Université;20;10;10;8;2;2023-04-05T22:46:28+02:00;Nanterre
Emeriau - Place de Brazzaville;51;1;48;40;8;2023-04-05T22:45:27+02:00;Paris
Francoeur - Marcadet;20;2;18;3;15;2023-04-05T22:47:08+02:00;Paris
Parc Monceau;18;15;3;1;2;2023-04-05T22:44:22+02:00;Paris
Henri Chevreau - Couronnes;27;1;23;1;22;2023-04-05T22:46:56+02:00;Paris
Place Valhubert;37;19;15;15;0;2023-04-05T22:46:56+02:00;Paris
Pascal - Claude Bernard;49;5;32;32;0;2023-04-05T22:46:05+02:00;Paris
Gare d'Austerlitz - Quai Saint-Bernard;27;27;0;0;0;2022-01-18T22:07:57+01:00;Paris
Sommerard - Saint-Jacques;34;27;2;1;1;2023-04-05T22:43:49+02:00;Paris
Vignerons - Minimes;29;25;4;2;2;2023-04-05T22:43:43+02:00;Vincennes
Lamennais - Washington;26;20;1;0;1;2023-04-05T22:47:06+02:00;Paris
Grenelle - Dr Finlay;71;2;64;60;4;2023-04-05T22:47:12+02:00;Paris
Batignolles - Place de Clichy;47;40;5;3;2;2023-04-05T22:46:52+02:00;Paris
Porte d'Orléans;48;45;3;1;2;2023-04-05T22:44:28+02:00;Paris
Pierre Grenier - Pont de Billancourt;21;0;17;14;3;2023-04-05T22:42:34+02:00;Boulogne-Billancourt
Pierre et Marie Curie - Julien Grimau;18;7;10;0;10;2023-04-05T22:45:06+02:00;Bagnolet
Vladimir Ilitch Lénine - Andrée Chedid;31;18;10;2;8;2023-04-05T22:46:57+02:00;Gentilly
Londres - Amsterdam;0;0;0;0;0;2023-01-09T05:28:33+01:00;Paris
Bineau - Louise Michel;25;17;6;4;2;2023-04-05T22:42:05+02:00;Levallois-Perret
Quai Voltaire;32;26;4;2;2;2023-04-05T22:42:48+02:00;Paris
Professeur René Leriche - Général Leclerc;50;43;5;1;4;2023-04-05T22:40:35+02:00;Clichy
Ledru-Rollin - Charonne;32;9;19;17;2;2023-04-05T22:45:57+02:00;Paris
Saint-François-Xavier;42;29;11;10;1;2023-04-05T22:46:24+02:00;Paris
Parc de Belleville - Julien Lacroix;26;13;13;2;11;2023-04-05T22:46:21+02:00;Paris
Uzès - Montmartre;29;23;4;3;1;2023-04-05T22:45:31+02:00;Paris
Morice - Général Leclerc;25;3;18;14;4;2023-04-05T22:46:36+02:00;Clichy
Gare de Pont-Cardinet;34;30;4;2;2;2023-04-05T22:45:58+02:00;Paris
Capitaine Glarner - Gabriel Péri;27;1;25;19;6;2023-04-05T22:44:20+02:00;Saint-Ouen-sur-Seine
Place Jean Delay;35;19;14;10;4;2023-04-05T22:44:35+02:00;Paris
Pierre Larousse - Raymond Losserand;30;20;10;3;7;2023-04-05T22:47:02+02:00;Paris
Pont de Levallois-bécon;50;44;3;1;2;2023-04-05T22:46:37+02:00;Levallois-Perret
Vasco de Gama;54;0;52;49;3;2023-04-05T22:46:58+02:00;Paris
Pitié-Salpêtrière;51;47;4;2;2;2023-04-05T22:46:20+02:00;Paris
Place du Général de Gaulle;28;25;3;2;1;2023-04-05T22:43:47+02:00;Fontenay-sous-Bois
Charles Delescluze;49;1;45;33;12;2023-04-05T22:43:24+02:00;Paris
Lauriston - Copernic;19;15;3;2;1;2023-04-05T22:46:41+02:00;Paris
Jonquoy - Didot;30;16;14;8;6;2023-04-05T22:46:45+02:00;Paris
Gare de l'Est - Verdun;14;12;1;1;0;2023-04-05T22:40:36+02:00;Paris
Lucien Sampaix - Récollets;46;41;3;2;1;2023-04-05T22:45:58+02:00;Paris
Bara - Henri Farman;36;32;1;1;0;2023-04-05T22:41:57+02:00;Issy-les-Moulineaux
Charenton - Place du Col Bourgoin;35;12;21;18;3;2023-04-05T22:46:44+02:00;Paris
Michelet - Assas;18;16;2;1;1;2023-04-05T22:42:39+02:00;Paris
Edouard Vaillant - Paul-Adolphe Souriau;28;27;0;0;0;2023-04-05T22:46:43+02:00;Boulogne-Billancourt
Belleville - Porte des Lilas;32;29;2;0;2;2023-04-05T22:39:04+02:00;Paris
Porte Dorée;36;27;7;6;1;2023-04-05T22:44:57+02:00;Paris
Mézières - Rennes;55;50;4;4;0;2023-04-05T22:45:37+02:00;Paris
Haxo - Surmelin;21;9;11;1;10;2023-04-05T22:42:41+02:00;Paris
Génie - Mozart;19;7;12;5;7;2023-04-05T22:45:27+02:00;Vitry-sur-Seine
Place Alphonse Deville;23;18;2;1;1;2023-04-05T22:42:23+02:00;Paris
Place du Maréchal Juin - Péreire;46;40;4;3;1;2023-04-05T22:42:51+02:00;Paris
Place Adolphe Cherioux - Vaugirard;63;3;57;44;13;2023-04-05T22:47:11+02:00;Paris
Gare de l'Est - Place du 11 Novembre 1918;40;36;2;1;1;2023-04-05T22:39:03+02:00;Paris
Sèvres-Gallieni;27;19;5;3;2;2023-04-05T22:47:08+02:00;Boulogne-Billancourt
Hôtel de Ville d'Argenteuil;30;21;9;6;3;2023-04-05T22:44:23+02:00;Argenteuil
Tanger - Place du Maroc;19;1;17;6;11;2023-04-05T22:47:12+02:00;Paris
Colonel Monteil - Brune;19;13;6;3;3;2023-04-05T22:45:21+02:00;Paris
Vincennes - Douy-Delcupe;38;28;7;3;4;2023-04-05T22:47:02+02:00;Montreuil
Verdun - Adrien Damalix;26;7;17;6;11;2023-04-05T22:44:40+02:00;Saint-Maurice
Place du Cornillon - Stade de France;35;34;1;1;0;2023-04-05T22:45:54+02:00;Saint-Denis
Edouard Pailleron - Simon Bolivar;24;15;6;3;3;2023-04-05T22:46:05+02:00;Paris
Porte de Clignancourt.;56;46;8;0;8;2023-04-05T22:43:31+02:00;Paris
Mairie du 18ème;40;34;3;3;0;2023-04-05T22:45:00+02:00;Paris
Porte de Saint-Ouen - Henri Huchard;26;25;1;1;0;2023-04-05T22:46:13+02:00;Paris
Laffitte - Italiens;33;33;0;0;0;2023-04-05T22:45:01+02:00;Paris
Lucie Aubrac - Franklin;36;33;3;1;2;2023-04-05T22:47:08+02:00;Montreuil
Indre - Prairies;38;26;12;2;10;2023-04-05T22:43:20+02:00;Paris
Gare Routière de Saint Cloud;31;17;13;8;5;2023-04-05T22:45:43+02:00;Saint-Cloud
Paris - Désiré Préaux;49;39;8;0;8;2023-04-05T22:44:33+02:00;Montreuil
Primo Levi - Frigos;34;34;0;0;0;2023-04-05T22:45:55+02:00;Paris
Gare d'Asnières sur Seine;24;0;21;10;11;2023-04-05T22:46:54+02:00;Asnières-sur-Seine
Belfort - Voltaire;39;2;35;33;2;2023-04-05T22:45:41+02:00;Paris
Courcelles - Pierre Demours;26;20;5;1;4;2023-04-05T22:46:31+02:00;Paris
Dunois - Clisson;51;47;4;3;1;2023-04-05T22:46:25+02:00;Paris
République - Danton;20;0;19;3;16;2023-04-05T22:46:55+02:00;Fontenay-sous-Bois
Batignolles - Rome;15;14;1;1;0;2023-04-05T22:45:11+02:00;Paris
Université Paris Dauphine;0;0;0;0;0;2018-03-09T08:53:33+01:00;Paris
Place Charles Vallin;26;0;26;21;5;2023-04-05T22:46:24+02:00;Paris
Mac-Mahon - Brey;25;24;1;1;0;2023-04-05T22:43:19+02:00;Paris
Milton - Manuel;22;16;6;4;2;2023-04-05T22:45:07+02:00;Paris
Chabrol - d'Hauteville;11;2;8;4;4;2023-04-05T22:47:03+02:00;Paris
Mahatma Gandhi;26;23;3;3;0;2023-04-05T22:40:42+02:00;Paris
Lepic - Armée d'Orient;24;13;8;0;8;2023-04-05T22:46:34+02:00;Paris
Eglise d'Auteuil;21;9;6;5;1;2023-04-05T22:44:09+02:00;Paris
Cité des Sciences et de l'Industrie;30;20;10;7;3;2023-04-05T22:44:19+02:00;Paris
Jean Jaurès - Jean Baptiste Clément;24;3;21;14;7;2023-04-05T22:46:35+02:00;Boulogne-Billancourt
Lassus - Delouvain;20;9;11;1;10;2023-04-05T22:42:56+02:00;Paris
Château - Bineau;23;19;3;1;2;2023-04-05T22:43:09+02:00;Neuilly-sur-Seine
Square du Carrefour de l'Insurrection;23;17;5;2;3;2023-04-05T22:46:02+02:00;Vanves
Bridaine - Lamandé;29;15;12;9;3;2023-04-05T22:44:47+02:00;Paris
François Ponsard - La Muette;23;6;17;0;17;2023-04-05T22:47:15+02:00;Paris
Porte de Ménilmontant;15;5;10;1;9;2023-04-05T22:44:29+02:00;Paris
Provence - Chaussée d'Antin;25;21;2;1;1;2023-04-05T22:45:50+02:00;Paris
Lourmel - Marie Skobtsov;22;2;20;17;3;2023-04-05T22:44:56+02:00;Paris
Pelleport - Belgrand;15;7;7;3;4;2023-04-05T22:47:16+02:00;Paris
Belleville - Télégraphe;41;34;5;1;4;2023-04-05T22:41:58+02:00;Paris
Assas - Vaugirard;35;32;2;1;1;2023-04-05T22:42:22+02:00;Paris
Danton - Serpente;22;13;5;4;1;2023-04-05T22:46:36+02:00;Paris
Place Etienne Pernet;43;9;33;29;4;2023-04-05T22:45:14+02:00;Paris
Square des Epinettes;20;1;19;12;7;2023-04-05T22:45:17+02:00;Paris
Porte d'Aubervilliers;55;45;5;4;1;2023-04-05T22:47:02+02:00;Paris
Les Planètes;16;2;14;7;7;2023-04-05T22:46:56+02:00;Maisons-Alfort
Sadi Carnot - François Mitterrand;27;19;8;1;7;2023-04-05T22:41:53+02:00;Bagnolet
Pajol - Riquet;47;9;36;12;24;2023-04-05T22:44:52+02:00;Paris
Gabrielle Josserand - Edouard Vaillant;25;9;15;13;2;2023-04-05T22:45:17+02:00;Pantin
Daumesnil - Picpus;21;1;23;17;6;2023-04-05T22:46:07+02:00;Paris
Théâtre - Lourmel;53;0;53;50;3;2023-04-05T22:47:12+02:00;Paris
Emile Blemont - Poteau;39;5;29;11;18;2023-04-05T22:46:03+02:00;Paris
Hameau Fleuri - Marché;22;12;9;8;1;2023-04-05T22:47:15+02:00;Boulogne-Billancourt
Toffier Decaux - Cartier Bresson;18;15;2;0;2;2023-04-05T22:40:03+02:00;Pantin
Balard - Montagne de la Fage;36;14;21;18;3;2023-04-05T22:46:57+02:00;Paris
Orteaux - Mouraud;24;16;6;2;4;2023-04-05T22:42:04+02:00;Paris
Place Pasdeloup;21;9;8;7;1;2023-04-05T22:47:14+02:00;Paris
Bellefond - Maubeuge;31;24;7;3;4;2023-04-05T22:47:12+02:00;Paris
Diderot - Pierre Bourdan;21;13;6;3;3;2023-04-05T22:45:30+02:00;Paris
Square Saint-Ambroise;43;4;34;30;4;2023-04-05T22:47:09+02:00;Paris
Méchain - Faubourg Saint-Jacques;16;15;1;1;0;2023-04-05T22:39:37+02:00;Paris
Charles de Gaulle - Jean Lolive;26;20;6;1;5;2023-04-05T22:46:00+02:00;Pantin
Stade Auguste Delaune;21;8;13;8;5;2023-04-05T22:45:06+02:00;Maisons-Alfort
Ecole Vétérinaire;36;9;25;12;13;2023-04-05T22:47:08+02:00;Maisons-Alfort
Jean-Baptiste Pigalle - La Bruyere;17;10;5;0;5;2023-04-05T22:41:55+02:00;Paris
Ledru-Rollin - Place du Père Chaillet;37;7;27;27;0;2023-04-05T22:44:04+02:00;Paris
Belliard - Damrémont;34;18;14;5;9;2023-04-05T22:45:20+02:00;Paris
Aubervilliers - Curial;23;13;10;2;8;2023-04-05T22:46:25+02:00;Paris
Route de la Muette - Porte de Neuilly;50;28;16;12;4;2023-04-05T22:46:04+02:00;Paris
Bassano -  Iéna;15;14;1;1;0;2023-04-05T22:42:44+02:00;Paris
Kléber - Gouverneur Général Eboué;24;9;10;6;4;2023-04-05T22:43:55+02:00;Issy-les-Moulineaux
Transvaal - Charles de Gaulle;27;20;4;2;2;2023-04-05T22:38:57+02:00;Boulogne-Billancourt
Président Wilson - Jean Jaures;27;14;9;4;5;2023-04-05T22:47:14+02:00;Levallois-Perret
Boulets - Faubourg Saint-Antoine;43;25;16;14;2;2023-04-05T22:47:00+02:00;Paris
Pyrénées - Maraîchers;19;4;12;4;8;2023-04-05T22:46:38+02:00;Paris
Haies - Réunion;22;7;12;4;8;2023-04-05T22:45:02+02:00;Paris
Gare RER de Saint-Denis;40;18;20;8;12;2023-04-05T22:47:04+02:00;Saint-Denis
Maine - Antoine Bourdelle;17;11;6;6;0;2023-04-05T22:46:56+02:00;Paris
Place de Passy;15;14;1;1;0;2023-04-05T22:44:58+02:00;Paris
Place Jacques Bonsergent;33;25;7;5;2;2023-04-05T22:47:10+02:00;Paris
Clichy - Place Blanche;20;9;12;6;6;2023-04-05T22:46:50+02:00;Paris
Square René Viviani - Montebello;34;14;14;9;5;2023-04-05T22:46:42+02:00;Paris
Pont Neuf - Rivoli;27;23;3;3;0;2023-04-05T22:44:45+02:00;Paris
Mozart - Jasmin;62;51;9;6;3;2023-04-05T22:46:06+02:00;Paris
Wilson - Landy;40;19;20;12;8;2023-04-05T22:43:07+02:00;Saint-Denis
Lavandieres Sainte Opportune - Rivoli;27;23;2;1;1;2023-04-05T22:47:07+02:00;Paris
Maison de Radio - France;47;22;18;16;2;2023-04-05T22:47:12+02:00;Paris
Caulaincourt - Place Constantin Pecqueur;44;35;8;1;7;2023-04-05T22:41:18+02:00;Paris
Naples - Rome;26;21;5;5;0;2023-04-05T22:45:32+02:00;Paris
Lallier - Trudaine;29;20;1;0;1;2023-04-05T22:46:58+02:00;Paris
Chernoviz - Raynouard;37;26;8;4;4;2023-04-05T22:39:50+02:00;Paris
Square Léon;33;11;22;3;19;2023-04-05T22:44:05+02:00;Paris
Pernety - Raymond Losserand;32;20;11;7;4;2023-04-05T22:45:53+02:00;Paris
Diderot - Reuilly;44;26;16;13;3;2023-04-05T22:44:17+02:00;Paris
Eugène Oudiné - Dessous Des Berges;44;39;3;3;0;2023-04-05T22:46:10+02:00;Paris
Fontainebleau - Edmond Michelet;45;35;10;3;7;2023-04-05T22:47:16+02:00;Le Kremlin-Bicêtre
Mont Valérien - Michel Salles;24;18;5;2;3;2023-04-05T22:41:00+02:00;Saint-Cloud
Eugène Reisz - Davout;20;15;2;0;2;2023-04-05T22:46:11+02:00;Paris
Gare Montparnasse - Vaugirard;66;61;4;4;0;2023-04-05T22:46:17+02:00;Paris
Traversière - Ledru-Rollin;34;2;27;25;2;2023-04-05T22:47:08+02:00;Paris
Neuve Saint-Pierre - Beautreillis;20;15;3;3;0;2023-04-05T22:45:31+02:00;Paris
Hôpital Pitié Salpêtrière;50;42;7;4;3;2023-04-05T22:47:04+02:00;Paris
Sabot - Rennes;26;20;5;5;0;2023-04-05T22:47:03+02:00;Paris
Villersexel - Saint-Germain;16;16;0;0;0;2023-04-05T22:45:14+02:00;Paris
Champ de Mars - Cler;41;9;31;26;5;2023-04-05T22:46:14+02:00;Paris
Pereire - Place de Wagram;46;40;6;3;3;2023-04-05T22:40:54+02:00;Paris
Sénat - Condé;33;12;2;1;1;2023-04-05T22:46:49+02:00;Paris
Palais des Sports;22;9;9;7;2;2023-04-05T22:47:10+02:00;Paris
Belleville - Pyrénées;42;31;8;0;8;2023-04-05T22:46:50+02:00;Paris
Granges aux Belles - Hôpital Saint-Louis;60;52;8;4;4;2023-04-05T22:44:54+02:00;Paris
Parc de Choisy;25;22;3;2;1;2023-04-05T22:43:29+02:00;Paris
Gustave Eiffel - Parc des Impressionnistes;30;9;19;14;5;2023-04-05T22:45:54+02:00;Clichy
Aqueduc - Villette;28;15;10;5;5;2023-04-05T22:46:59+02:00;Paris
Borrégo - Gambetta;25;20;5;1;4;2023-04-05T22:47:11+02:00;Paris
Billancourt - Général Leclerc;22;11;9;7;2;2023-04-05T22:44:07+02:00;Boulogne-Billancourt
Jeanne Hornet - Girardot;29;22;5;0;5;2023-04-05T22:46:24+02:00;Bagnolet
François 1er - Montaigne;29;29;0;0;0;2023-04-05T22:39:54+02:00;Paris
Manin - Simon Bolivar;26;15;8;2;6;2023-04-05T22:46:06+02:00;Paris
Surcouf - Université;58;49;5;5;0;2023-04-05T22:47:01+02:00;Paris
Calmette;32;23;7;0;7;2023-04-05T22:40:42+02:00;Les Lilas
Hôtel de Ville de Champigny sur Marne;21;3;16;13;3;2023-04-05T22:45:17+02:00;Champigny-sur-Marne
Duroc - Place de Breteuil;42;36;6;5;1;2023-04-05T22:46:14+02:00;Paris
Raspail - Chomel;49;45;4;2;2;2023-04-05T22:46:21+02:00;Paris
Favart - Italiens;17;16;0;0;0;2023-04-05T22:43:27+02:00;Paris
Faubourg Poissonniere - Delta;36;27;8;5;3;2023-04-05T22:46:01+02:00;Paris
Parvis Corentin Celton;55;6;44;40;4;2023-04-05T22:46:52+02:00;Issy-les-Moulineaux
Place François Mitterand;34;29;2;0;2;2023-04-05T22:46:45+02:00;Montreuil
Bois de Vincennes.;60;49;9;7;2;2023-04-05T22:43:53+02:00;Saint-Mandé
Greneta - Sebastopol;32;29;0;0;0;2023-04-05T22:42:32+02:00;Paris
Parc André Citroën;65;7;52;51;1;2023-04-05T22:43:52+02:00;Paris
Place du Maquis du Vercors;31;20;11;0;11;2023-04-05T22:46:37+02:00;Paris
Ney - Charles Hermite;20;15;5;2;3;2023-04-05T22:45:00+02:00;Paris
Poissonniers - Nord;28;21;7;6;1;2023-04-05T22:43:30+02:00;Paris
Beaujon - Wagram;29;27;1;0;1;2023-04-05T22:46:29+02:00;Paris
Reims - Porte d'Asnières;26;24;2;0;2;2023-04-05T22:39:10+02:00;Paris
Vieille du Temple - Francs Bourgeois;29;17;8;4;4;2023-04-05T22:46:14+02:00;Paris
Saint-Jacques - Tombe Issoire;23;20;3;3;0;2023-04-05T22:47:15+02:00;Paris
Hôtel de Ville - Pont-Marie;36;9;21;21;0;2023-04-05T22:47:07+02:00;Paris
Brochant - Square des Batignolles;31;22;8;5;3;2023-04-05T22:47:02+02:00;Paris
Porte d'Ivry;50;48;1;1;0;2023-04-05T22:46:46+02:00;Paris
Dupont de l'Eure - Gambetta;31;27;4;0;4;2023-04-05T22:40:04+02:00;Paris
Gare du Nord - Demarquay;30;21;8;6;2;2023-04-05T22:46:32+02:00;Paris
Keller - La Roquette;34;4;29;28;1;2023-04-05T22:47:08+02:00;Paris
Place Pigalle;21;5;15;1;14;2023-04-05T22:46:19+02:00;Paris
Vistule - Choisy;33;30;3;0;3;2023-04-05T22:45:18+02:00;Paris
Bercy.;66;60;4;3;1;2023-04-05T22:46:09+02:00;Paris
Nationale - Marcel Duchamp;23;16;6;4;2;2023-04-05T22:39:22+02:00;Paris
Centenaire - Sorins;45;37;7;0;7;2023-04-05T22:45:24+02:00;Montreuil
Charonne - Philippe-Auguste;32;17;14;6;8;2023-04-05T22:41:36+02:00;Paris
Damrémont - Caulaincourt;18;12;6;0;6;2023-04-05T22:40:32+02:00;Paris
Hôtel de Ville de Levallois Perret;26;16;9;7;2;2023-04-05T22:47:04+02:00;Levallois-Perret
Franciade - Gabriel Péri;26;13;8;4;4;2023-04-05T22:45:48+02:00;Saint-Denis
Place de Finlande;25;21;1;1;0;2023-04-05T22:46:29+02:00;Paris
Poissy - Saint-Germain;25;12;11;11;0;2023-04-05T22:45:21+02:00;Paris
Les Juilliottes;21;4;16;10;6;2023-04-05T22:45:43+02:00;Maisons-Alfort
Square Raymond Souplex;52;12;34;12;22;2023-04-05T22:46:17+02:00;Paris
République - Henri Barbusse;32;13;19;9;10;2023-04-05T22:43:09+02:00;Aubervilliers
Convention - Saint-Charles;19;1;17;16;1;2023-04-05T22:43:31+02:00;Paris
Jeûneurs - Mulhouse;28;14;12;9;3;2023-04-05T22:46:17+02:00;Paris
Parmentier - Fontaine au Roi;48;11;35;23;12;2023-04-05T22:45:52+02:00;Paris
Faidherbe - Dahomey;44;15;29;24;5;2023-04-05T22:46:03+02:00;Paris
Thérèse - Opéra;25;21;2;1;1;2023-04-05T22:41:29+02:00;Paris
Versailles - Claude Terrasse;46;21;22;17;5;2023-04-05T22:47:03+02:00;Paris
Rougemont - Poissonnière;30;26;2;1;1;2023-04-05T22:47:12+02:00;Paris
Mornay - Sully;15;1;15;12;3;2023-04-05T22:47:05+02:00;Paris
Mairie du 15ème;32;0;31;28;3;2023-04-05T22:47:06+02:00;Paris
Parc de Sceaux - Centre-Ville;33;19;14;2;12;2023-04-05T22:46:16+02:00;Sceaux
Place des Larris;34;30;4;2;2;2023-04-05T22:45:09+02:00;Fontenay-sous-Bois
Ferrus - Saint-Jacques;34;31;3;1;2;2023-04-05T22:40:13+02:00;Paris
Manin - Crimée;23;2;17;1;16;2023-04-05T22:44:33+02:00;Paris
Pierre Sarrazin - Saint-Michel;33;28;2;2;0;2023-04-05T22:46:04+02:00;Paris
Square Desnouettes;22;2;19;17;2;2023-04-05T22:46:33+02:00;Paris
Bachaumont - Montmartre;33;19;10;9;1;2023-04-05T22:46:18+02:00;Paris
Saint-Blaise - Mouraud;27;14;13;3;10;2023-04-05T22:44:02+02:00;Paris
Place Tony de Graaff;42;22;20;11;9;2023-04-05T22:47:15+02:00;Meudon
Roquépine - Malesherbes;37;34;1;0;1;2023-04-05T22:42:08+02:00;Paris
Sorbonne - Ecoles;50;45;2;1;1;2023-04-05T22:42:50+02:00;Paris
Paul Doumer - La Tour;34;28;4;1;3;2023-04-05T22:37:52+02:00;Paris
Claude Vellefaux - Sambre et Meuse;34;11;21;14;7;2023-04-05T22:46:30+02:00;Paris
Mairie de Clichy;51;21;27;22;5;2023-04-05T22:47:15+02:00;Clichy
Place du Canada;29;20;0;0;0;2023-04-05T22:44:44+02:00;Paris
Pont de Lodi - Dauphine;23;7;14;14;0;2023-04-05T22:44:23+02:00;Paris
Lamartine - Faubourg Montmartre;32;20;9;8;1;2023-04-05T22:43:50+02:00;Paris
Romain Rolland;25;21;4;1;3;2023-04-05T22:43:56+02:00;Montrouge
Mairie du 19ème;27;14;12;5;7;2023-04-05T22:44:27+02:00;Paris
Gambetta - Michelet;33;18;14;7;7;2023-04-05T22:46:54+02:00;Montreuil
Square du Bataclan;20;9;8;8;0;2023-04-05T22:40:06+02:00;Paris
Danielle Casanova - Place Vendôme;37;34;1;0;1;2023-04-05T22:46:09+02:00;Paris
Montreuil - Voltaire;34;21;10;6;4;2023-04-05T22:47:08+02:00;Paris
Fernand Braudel - Vincent Auriol;36;35;1;0;1;2023-04-05T22:47:16+02:00;Paris
Melun - Jean Jaurès;28;28;0;0;0;2023-01-15T20:52:13+01:00;Paris
Georges V - François 1er;22;22;0;0;0;2023-04-05T22:40:08+02:00;Paris
Jean Jaurès - Reine;31;15;14;14;0;2023-04-05T22:46:22+02:00;Boulogne-Billancourt
Bleue - Trévise;30;22;5;4;1;2023-04-05T22:47:07+02:00;Paris
Argenson - Château;25;21;3;2;1;2023-04-05T22:46:59+02:00;Neuilly-sur-Seine
Le Vau - Maurice Bertaux;25;23;0;0;0;2023-04-05T22:47:03+02:00;Paris
Place de l'Eglise - Pantin;30;20;8;1;7;2023-04-05T22:43:13+02:00;Pantin
Daunou - Louis le Grand;17;14;1;1;0;2023-04-05T22:45:34+02:00;Paris
Butte aux Cailles - Esperance;36;29;7;3;4;2023-04-05T22:46:42+02:00;Paris
Porte Saint-Martin;34;16;15;14;1;2023-04-05T22:45:22+02:00;Paris
Louis Ganne - Davout;30;27;3;0;3;2023-04-05T22:41:32+02:00;Paris
François 1er - Lincoln;31;31;0;0;0;2023-04-05T22:46:18+02:00;Paris
Roquette - Folie Regnault;52;30;22;14;8;2023-04-05T22:47:04+02:00;Paris
Place Mireille Havet;43;4;35;30;5;2023-04-05T22:46:44+02:00;Paris
Brochant - Clichy;53;19;30;20;10;2023-04-05T22:46:41+02:00;Paris
Square Georges Melies;40;33;6;3;3;2023-04-05T22:43:20+02:00;Paris
Place Marcel Sembat;56;33;20;19;1;2023-04-05T22:44:45+02:00;Boulogne-Billancourt
Jardin Marguerite Long;22;19;3;1;2;2023-04-05T22:43:24+02:00;Paris
René Coty - Parc Montsouris;55;46;9;4;5;2023-04-05T22:47:06+02:00;Paris
Vignes - Boulainvilliers;21;20;1;1;0;2023-04-05T22:47:07+02:00;Paris
René Binet - Porte de Montmartre;37;32;5;1;4;2023-04-05T22:43:16+02:00;Paris
Tremblay - Lac des Minimes;48;42;4;2;2;2023-04-05T22:45:37+02:00;Paris
Moulin de la Pointe;22;17;5;2;3;2023-04-05T22:44:47+02:00;Paris
Terroirs de France - Lheureux;55;48;6;5;1;2023-04-05T22:47:14+02:00;Paris
Sèvres Rive Gauche;33;31;1;0;1;2023-04-05T22:43:09+02:00;Sèvres
Censier - Jardin des Plantes;28;1;19;15;4;2023-04-05T22:47:14+02:00;Paris
Gare de Clichy-Levallois;26;22;3;0;3;2023-04-05T22:46:57+02:00;Levallois-Perret
Odessa - Départ;39;37;2;0;2;2023-04-05T22:38:53+02:00;Paris
Dareau - Broussais;24;12;12;3;9;2023-04-05T22:46:47+02:00;Paris
François Truffaut - Saint Emilion;66;41;22;22;0;2023-04-05T22:47:11+02:00;Paris
Le Corbusier - Jean Jaurès;46;27;17;16;1;2023-04-05T22:47:00+02:00;Boulogne-Billancourt
Lac Daumesnil - Saint-Maurice;50;49;1;0;1;2023-04-05T22:42:49+02:00;Paris
Beaumarchais - Pas de la Mule;18;4;13;11;2;2023-04-05T22:44:12+02:00;Paris
Madeleine Michelis - Roule;25;17;6;4;2;2023-04-05T22:47:13+02:00;Neuilly-sur-Seine
Jean Moulin - Paul Doumer;20;15;5;2;3;2023-04-05T22:45:13+02:00;Montreuil
Jessaint - Marx Dormoy;30;10;18;11;7;2023-04-05T22:46:58+02:00;Paris
Véron - Lepic;23;7;14;3;11;2023-04-05T22:43:58+02:00;Paris
Léon - Doudeauville;13;0;12;8;4;2023-04-05T22:45:06+02:00;Paris
Pont De Charenton;18;0;15;11;4;2023-04-05T22:44:41+02:00;Saint-Maurice
Quai Marcel Boyer - Victor Hugo;29;2;26;17;9;2023-04-05T22:47:12+02:00;Ivry-sur-Seine
Pierre Brossolette - Adolphe Pinard;24;15;9;2;7;2023-04-05T22:45:59+02:00;Malakoff
Suffren - Pérignon;46;16;28;20;8;2023-04-05T22:46:58+02:00;Paris
Gare de Nanterre Ville;43;12;28;26;2;2023-04-05T22:47:01+02:00;Nanterre
Docteur Calmette - Martre;30;15;13;7;6;2023-04-05T22:43:45+02:00;Clichy
Senard - Charles Blum;24;11;11;6;5;2023-04-05T22:46:37+02:00;Saint-Cloud
Saint-Fargeau - Mortier;33;33;0;0;0;2023-04-05T22:37:15+02:00;Paris
Cours de Vincennes - Davout;48;41;7;4;3;2023-04-05T22:46:39+02:00;Paris
République - Auguste Perret;30;19;11;1;10;2023-04-05T22:43:28+02:00;Villejuif
Charles de Gaulle - Orléans;26;24;2;2;0;2023-04-05T22:45:35+02:00;Neuilly-sur-Seine
Mairie du 9ème;24;21;2;1;1;2023-04-05T22:47:00+02:00;Paris
Gergovie - Vercingétorix;29;20;8;5;3;2023-04-05T22:47:03+02:00;Paris
Boutroux - Porte de Vitry;49;23;24;19;5;2023-04-05T22:45:32+02:00;Paris
Commandant l'Herminier - Gallieni;17;15;2;2;0;2023-04-05T22:42:37+02:00;Paris
Jules Guesde - Alsace;25;14;12;8;4;2023-04-05T22:47:08+02:00;Levallois-Perret
Sambre et Meuse - Villette;25;9;12;5;7;2023-04-05T22:47:06+02:00;Paris
Place Centrale;22;20;2;0;2;2023-04-05T22:41:24+02:00;Meudon
Rapp - Place du Général Gouraud;31;13;16;15;1;2023-04-05T22:44:25+02:00;Paris
Station Paris Basketball - Stade Georges Carpentier;40;39;1;1;0;2023-04-05T22:40:10+02:00;Paris
Pyramide - Parc Floral;50;45;3;0;3;2023-04-05T22:41:54+02:00;Paris
Jules Guesde - Laennec;19;15;4;0;4;2023-04-05T22:45:22+02:00;Rosny-sous-Bois
Demi-Lune - Aristide Briand;20;0;18;4;14;2023-04-05T22:45:03+02:00;Montreuil
Guy Môquet - Saint-Ouen;53;20;28;21;7;2023-04-05T22:46:12+02:00;Paris
Square Edmond Pépin;30;16;13;2;11;2023-04-05T22:46:13+02:00;Le Pré-Saint-Gervais
Bois de Vincennes - Porte Jaune;35;33;0;0;0;2023-04-05T22:44:56+02:00;Paris
Boussingault - Tolbiac;28;1;27;23;4;2023-04-05T22:45:26+02:00;Paris
Pré Saint-Gervais - Lilas;28;17;7;0;7;2023-04-05T22:42:40+02:00;Paris
Jacquard - Ternaux;39;3;34;31;3;2023-04-05T22:46:49+02:00;Paris
Choron - Martyrs;17;9;4;4;0;2023-04-05T22:45:32+02:00;Paris
Honoré d'Estienne d'Ovres - Grilles;18;8;7;2;5;2023-04-05T22:46:18+02:00;Pantin
Place du Président Salvador Allende;60;57;2;0;2;2023-04-05T22:46:34+02:00;Pantin
Hôpital Robert Debré;33;27;1;0;1;2023-04-05T22:45:03+02:00;Paris
Bastille - Quai de la Rapée;27;3;22;22;0;2023-04-05T22:46:47+02:00;Paris
Santé - Arago;38;32;6;5;1;2023-04-05T22:40:55+02:00;Paris
Clapeyron - Moscou;15;11;4;3;1;2023-04-05T22:45:54+02:00;Paris
Place du Front Populaire - George Sand;35;33;0;0;0;2023-04-05T22:44:04+02:00;Saint-Denis
Paul Klee - Place Augusta Holmes;43;42;0;0;0;2023-04-05T22:44:53+02:00;Paris
Paul Barruel - Vaugirard;39;1;38;25;13;2023-04-05T22:43:41+02:00;Paris
Alexander Fleming - Belvédère;31;29;1;0;1;2023-04-05T22:40:57+02:00;Paris
Auguste Blanqui - Glacière;60;50;9;7;2;2023-04-05T22:44:20+02:00;Paris
Gare du Nord - Place de Valenciennes;25;23;1;0;1;2023-04-05T22:40:02+02:00;Paris
Louis Blanc - Jemmapes;31;25;5;1;4;2023-04-05T22:45:30+02:00;Paris
Averroès - Aimé Césaire;19;12;6;2;4;2023-04-05T22:46:41+02:00;Pantin
Charles Lecocq - Lecourbe;30;1;29;23;6;2023-04-05T22:45:16+02:00;Paris
Place de la Montagne du Goulet;21;4;15;15;0;2023-04-05T22:46:25+02:00;Paris
Quai de Valmy;26;20;3;2;1;2023-04-05T22:44:07+02:00;Paris
Longchamp - Place d'Iéna;40;38;1;0;1;2023-04-05T22:44:03+02:00;Paris
Square de la rue Pixérécourt;15;1;13;0;13;2023-04-05T22:44:17+02:00;Paris
Eylau - Trocadéro;24;20;1;0;1;2023-04-05T22:46:11+02:00;Paris
Gare de Lyon - Van Gogh;51;46;3;2;1;2023-04-05T22:39:48+02:00;Paris
Athènes - Clichy;20;19;0;0;0;2023-04-05T22:44:01+02:00;Paris
Parc Suzanne Lenglen;52;51;0;0;0;2023-04-05T22:38:29+02:00;Paris
Mazagran - Pierre de Coubertin;15;8;7;3;4;2023-04-05T22:42:42+02:00;Paris
Edouard Vaillant - Galliéni;49;49;0;0;0;2020-08-14T04:12:17+02:00;Bagnolet
Pierre Demours - Laugier;37;25;8;6;2;2023-04-05T22:46:52+02:00;Paris
Cimetière d'Issy-les-Moulineaux;24;19;5;0;5;2023-04-05T22:45:21+02:00;Issy-les-Moulineaux
Metz - Faubourg Saint-Denis;48;22;22;22;0;2023-04-05T22:46:11+02:00;Paris
Joseph Sansboeuf - Saint Lazare;18;17;1;0;1;2023-04-05T22:44:01+02:00;Paris
Neuilly - Petit;16;8;4;4;0;2023-04-05T22:46:36+02:00;Clichy
Censier - Santeuil;69;38;28;25;3;2023-04-05T22:47:13+02:00;Paris
Pelée - Alphonse Baudin;38;4;33;31;2;2023-04-05T22:47:08+02:00;Paris
Mairie de Neuilly sur Seine;31;24;5;5;0;2023-04-05T22:44:15+02:00;Neuilly-sur-Seine
Place Jules Ferry;28;19;9;4;5;2023-04-05T22:46:11+02:00;Montrouge
Chancé Milly - Cimetière Communal Sud;32;21;10;5;5;2023-04-05T22:45:03+02:00;Clichy
Gare de l'Est - Fidélité;15;9;3;2;1;2023-04-05T22:46:58+02:00;Paris
Cours de l'Ile Seguin - Parc Billancourt;29;26;0;0;0;2023-04-05T22:46:40+02:00;Boulogne-Billancourt
Botzaris - Crimée;21;5;16;1;15;2023-04-05T22:47:03+02:00;Paris
Gare du Nord - Denain;20;17;0;0;0;2023-04-05T22:41:04+02:00;Paris
Saint-Didier - Raymond Poincaré;17;16;0;0;0;2023-04-05T22:39:44+02:00;Paris
Marcel Yol - Jullien;30;16;13;2;11;2023-04-05T22:41:47+02:00;Vanves
Ecole Militaire - Place Joffre;26;24;1;1;0;2023-04-05T22:45:07+02:00;Paris
Marc Sangnier - Division Leclerc;24;13;9;8;1;2023-04-05T04:28:35+02:00;Cachan
Belleville - Couronnes;50;2;47;24;23;2023-04-05T22:47:13+02:00;Paris
Pierre Levée - Fontaine Timbaud;23;8;14;11;3;2023-04-05T22:46:30+02:00;Paris
Place Fernand Forest;33;6;26;26;0;2023-04-05T22:44:12+02:00;Paris
Raffet - Montmorency;42;37;2;2;0;2023-04-05T22:47:04+02:00;Paris
Gare Montparnasse - Edgar Quinet;33;32;1;1;0;2023-04-05T22:43:41+02:00;Paris
Ivry - Simone Weil;18;17;1;1;0;2023-04-05T22:47:05+02:00;Paris
Wurtz - Tolbiac;28;0;25;21;4;2023-04-05T22:45:52+02:00;Paris
Cimetière de Boulogne-Billancourt;40;7;30;23;7;2023-04-05T22:46:27+02:00;Boulogne-Billancourt
Hôtel de ville de Fontenay-sous-Bois;20;15;5;0;5;2023-04-05T22:40:32+02:00;Fontenay-sous-Bois
Gare SNCF Vanves-Malakoff;51;43;8;6;2;2023-04-05T22:46:47+02:00;Vanves
Carnot - Général Lanrezac;30;30;0;0;0;2018-05-21T07:30:29+02:00;Paris
Brancion - Lefebvre;11;5;5;2;3;2023-04-05T22:43:37+02:00;Paris
Convention - Vaugirard;48;5;38;31;7;2023-04-05T22:47:12+02:00;Paris
Docteurs Déjérine - Pte de Montreuil;20;19;1;1;0;2023-04-05T22:43:33+02:00;Paris
Résistance - Hoche;29;25;2;0;2;2023-04-05T22:43:19+02:00;Montreuil
Vanne - Général de Gaulle;25;21;4;0;4;2023-04-05T22:44:16+02:00;Montrouge
Paul Vaillant-Couturier - Gare RER;26;1;21;10;11;2023-04-05T22:44:22+02:00;Vitry-sur-Seine
Malakoff - Place de la Porte Maillot;31;16;0;0;0;2023-04-05T22:46:27+02:00;Paris
Commerce - Letellier;44;4;39;33;6;2023-04-05T12:17:39+02:00;Paris
Jean-Pierre Timbaud - Vaucouleurs;47;10;37;26;11;2023-04-05T22:46:45+02:00;Paris
Fessart - Château;20;4;15;9;6;2023-04-05T22:46:58+02:00;Boulogne-Billancourt
Pierre Lefaucheux - Traversière;35;3;31;25;6;2023-04-05T22:46:04+02:00;Boulogne-Billancourt
Ranelagh - Maison de la Radio;22;16;4;2;2;2023-04-05T22:41:27+02:00;Paris
Victor Cresson - Telles de la Poterie;31;2;26;22;4;2023-04-05T22:46:57+02:00;Issy-les-Moulineaux
Place Saint-Ferdinand;38;35;3;1;2;2023-04-05T22:46:06+02:00;Paris
Buzenval - Avron;50;39;11;4;7;2023-04-05T22:43:40+02:00;Paris
Hôtel de Ville de Fontenay-aux-Roses;34;23;11;1;10;2023-04-05T22:43:10+02:00;Fontenay-aux-Roses
George V - Christophe Colomb;24;23;1;0;1;2023-04-05T22:38:26+02:00;Paris
Vinaigriers - Magenta;25;10;13;12;1;2023-04-05T22:47:17+02:00;Paris
Amaury Duval - Gabriel Péri;36;28;7;3;4;2023-04-05T22:46:59+02:00;Montrouge
Vanne - Saussaies;20;9;11;0;11;2023-04-05T22:46:21+02:00;Cachan
Square Alban Satragne;30;23;3;2;1;2023-04-05T22:46:27+02:00;Paris
Bruneseau - Quai d'Ivry;48;32;11;8;3;2023-04-05T22:41:23+02:00;Ivry-sur-Seine
Paul Signac - Aristide Briand;35;22;11;0;11;2023-04-05T22:43:42+02:00;Montreuil
André Maurois - Joseph et Marie Hackin;29;23;4;1;3;2023-04-05T22:45:11+02:00;Paris
Proudhon - Président Wilson;30;30;0;0;0;2023-04-05T22:38:22+02:00;Saint-Denis
Pontoise - La Tournelle;23;3;14;13;1;2023-04-05T22:44:01+02:00;Paris
Stade de France;44;38;5;3;2;2023-04-05T22:39:40+02:00;Saint-Denis
Mairie de Romainville;17;3;11;1;10;2023-04-05T22:45:42+02:00;Romainville
Charles Gide - Fort de Bicêtre;30;17;12;2;10;2023-04-05T22:45:08+02:00;Le Kremlin-Bicêtre
Daumesnil - Hébrard;40;5;34;30;4;2023-04-05T22:46:53+02:00;Paris
Vitruve - Davout;23;14;9;0;9;2023-04-05T22:45:59+02:00;Paris
Jardin de l'Hospice Debrousse;23;15;8;1;7;2023-04-05T22:46:29+02:00;Paris
Place Nationale - Château-des-Rentiers;18;13;5;2;3;2023-04-05T22:47:04+02:00;Paris
Hôpital - Campo-Formio;16;9;6;5;1;2023-04-05T22:43:51+02:00;Paris
Quai aux Fleurs - Pont Saint-Louis;21;1;20;19;1;2023-04-05T22:47:00+02:00;Paris
Jean Calvin - Tournefort;28;26;2;1;1;2023-04-05T22:46:26+02:00;Paris
Place de Barcelone - Mirabeau;55;9;38;36;2;2023-04-05T22:44:51+02:00;Paris
Charles de Gaulle - Graviers;0;0;0;0;0;2022-12-05T06:50:36+01:00;Neuilly-sur-Seine
Batignolles - Beudant;44;35;7;4;3;2023-04-05T22:45:12+02:00;Paris
Porte d'Italie;13;13;0;0;0;2023-04-05T22:46:30+02:00;Paris
Théâtre de La Garenne;20;14;4;1;3;2023-04-05T22:45:44+02:00;La Garenne-Colombes
Place de la Porte de Passy;36;34;2;1;1;2023-04-05T22:41:48+02:00;Paris
La Motte-Picquet - Grenelle;34;4;26;26;0;2023-04-05T22:47:08+02:00;Paris
Temple - Charlot;45;7;32;28;4;2023-04-05T22:46:03+02:00;Paris
Arcole - Notre-Dame;31;26;5;5;0;2023-04-05T22:43:48+02:00;Paris
Damrémont - Ordener;30;3;24;11;13;2023-04-05T22:45:52+02:00;Paris
Quai de la Gare - Pont de Bercy;30;22;6;5;1;2023-04-05T22:44:39+02:00;Paris
Place de Lévis;48;42;4;2;2;2023-04-05T22:40:37+02:00;Paris
Place de l'Insurrection d'Août 1944;30;5;25;20;5;2023-04-05T22:46:19+02:00;Ivry-sur-Seine
Président Wilson - Baudin;28;16;11;3;8;2023-04-05T22:45:42+02:00;Levallois-Perret
Porte d'Asnières;36;25;7;4;3;2023-04-05T22:42:02+02:00;Paris
Jourdan - Monticelli;30;29;0;0;0;2023-04-05T22:46:25+02:00;Paris
Gaston Tessier - Rosa Parks RER;37;32;4;1;3;2023-04-05T22:45:24+02:00;Paris
Assas - Luxembourg;33;32;0;0;0;2023-04-05T22:42:06+02:00;Paris
Camille Groult - Guy Môquet;22;2;20;16;4;2023-04-05T22:46:50+02:00;Vitry-sur-Seine
Jean Jaurès - Ouvrières Pivéreuses;20;11;7;0;7;2023-04-05T22:44:48+02:00;Pantin
Lobau - Hôtel de Ville;60;27;31;29;2;2023-04-05T22:45:45+02:00;Paris
Estienne d'Orves - Henri Ginoux;31;23;8;5;3;2023-04-05T22:42:45+02:00;Montrouge
Mazagran - Bonne Nouvelle;25;23;2;1;1;2023-04-05T22:47:15+02:00;Paris
Place de l'Europe - Quai de Bercy;17;9;7;6;1;2023-04-05T22:44:09+02:00;Charenton-le-Pont
Raspail - Albert Schweitzer;28;1;26;21;5;2023-04-05T22:44:16+02:00;Gentilly
Paris - Laitières;22;18;4;2;2;2023-04-05T22:46:21+02:00;Vincennes
Brillat-Savarin - Küss;21;4;16;13;3;2023-04-05T22:44:05+02:00;Paris
Louis Pasteur - Albert Petit;31;19;10;0;10;2023-04-05T22:45:41+02:00;Bagneux
Marché aux fleurs;23;17;4;3;1;2023-04-05T22:46:58+02:00;Paris
Jean Moulin - Place Victor et Hélène Basch;41;35;6;0;6;2023-04-05T22:47:15+02:00;Paris
Bobillot - Paulin Mery;23;22;0;0;0;2023-04-05T22:40:41+02:00;Paris
Javel - André Citroën;45;11;28;17;11;2023-04-05T22:46:57+02:00;Paris
Jacques Kellner - Saint-Ouen;45;21;24;12;12;2023-04-05T22:46:39+02:00;Paris
Emeriau - Beaugrenelle;74;12;58;53;5;2023-04-05T22:46:48+02:00;Paris
Louis Rolland - République;26;21;5;0;5;2023-04-05T22:40:28+02:00;Montrouge
Faubourg Poissonnière - Dunkerque;30;24;5;3;2;2023-04-05T22:43:55+02:00;Paris
Gare de Lyon - Chalon;45;29;15;13;2;2023-04-05T22:46:13+02:00;Paris
Victor Hugo - La Pompe;41;26;2;0;2;2023-04-05T22:46:46+02:00;Paris
Place Mongolfier;39;5;31;28;3;2023-04-05T22:46:54+02:00;Saint-Maurice
Colmar - Victor Hugo;32;26;2;2;0;2023-04-05T22:46:45+02:00;Rueil-Malmaison
Mairie de quartier du Plateau - Mont-Valérien;20;12;8;2;6;2023-04-05T22:46:10+02:00;Nanterre
Charonne - Pierre Bayle;23;21;1;1;0;2023-04-05T22:47:14+02:00;Paris
Paul Vaillant-Couturier - Victor Hugo;36;22;7;3;4;2023-04-05T22:42:13+02:00;Levallois-Perret
Benjamin Delessert - Jean Lolive;21;12;8;2;6;2023-04-05T22:41:34+02:00;Pantin
Goutte d'or - Barbès;20;3;17;7;10;2023-04-05T22:45:33+02:00;Paris
Place de la Gare;46;14;31;29;2;2023-04-05T22:47:14+02:00;Maisons-Alfort
Quai de l'Oise - Aisne;30;2;26;8;18;2023-04-05T22:46:17+02:00;Paris
Italie - Jardin Joan Miro;26;25;1;0;1;2023-04-05T22:45:09+02:00;Paris
Place Edmond Michelet;23;18;2;0;2;2023-04-05T22:46:57+02:00;Paris
Place Lafayette;62;57;3;1;2;2023-04-05T22:46:12+02:00;Issy-les-Moulineaux
Emile Zola - Fondary;42;6;35;30;5;2023-04-05T22:46:33+02:00;Paris
Monceau - Malesherbes;38;35;1;0;1;2023-04-05T22:47:17+02:00;Paris
Taitbout - La Fayette;53;48;1;0;1;2023-04-05T22:47:14+02:00;Paris
Gare de la Garenne-Colombes;28;15;10;6;4;2023-04-05T22:47:14+02:00;Colombes
Charles Tillon - Cimetière Communal;30;8;17;6;11;2023-04-05T22:46:42+02:00;Aubervilliers
Lucien Lanternier - Le Luth;27;10;17;11;6;2023-04-05T22:46:41+02:00;Gennevilliers
La Motte-Picquet - La Tour Maubourg;40;25;14;12;2;2023-04-05T22:45:14+02:00;Paris
Rond-Point de la Chapelle;0;0;0;0;0;2023-02-21T23:23:33+01:00;Paris
Maréchal Joffre - Verdun;20;10;10;0;10;2023-04-05T22:41:38+02:00;Fontenay-sous-Bois
La Jarry - Place Diderot;25;6;18;8;10;2023-04-05T22:46:33+02:00;Vincennes
Rochechouart - Martyrs;20;16;1;0;1;2023-04-05T22:45:16+02:00;Paris
Berthier - Place Stuart Merril;37;28;9;6;3;2023-04-05T22:42:58+02:00;Paris
Île de la Jatte;23;9;13;6;7;2023-04-05T22:44:08+02:00;Neuilly-sur-Seine
Place Jacques et Thérèse Tréfouël;43;41;2;1;1;2023-04-05T22:45:34+02:00;Paris
Balzac - Olympes de Gouges;28;4;22;11;11;2023-04-05T22:45:32+02:00;Vitry-sur-Seine
Lucien Bossoutrot - Général Martial Vallin;39;37;1;1;0;2023-04-05T22:46:43+02:00;Paris
Place Saint-Just;22;0;22;8;14;2023-04-05T22:42:16+02:00;Vitry-sur-Seine
Pergolèse - Malakoff;38;34;3;1;2;2023-04-05T22:46:03+02:00;Paris
Cambronne - Villa Croix Nivert;62;21;39;33;6;2023-04-05T22:45:43+02:00;Paris
Vaugirard - Pasteur;21;19;0;0;0;2023-04-05T22:45:17+02:00;Paris
Gérando - Rochechouart;21;12;8;3;5;2023-04-05T22:47:09+02:00;Paris
Voltaire - Anatole France;27;24;1;1;0;2023-04-05T22:46:39+02:00;Levallois-Perret
Placette Grégoire Collas;24;9;15;12;3;2023-04-05T22:44:42+02:00;Argenteuil
Blaise-Desgoffe - Vaugirard;32;28;3;0;3;2023-04-05T22:45:54+02:00;Paris
Square Bela Bartok;24;2;21;21;0;2023-04-05T22:44:10+02:00;Paris
Place du 14 Juillet;22;3;16;4;12;2023-04-05T22:43:28+02:00;Malakoff
Fort d'Aubervilliers;22;7;13;7;6;2023-04-05T22:47:08+02:00;Aubervilliers
Charonne - Bureau;47;26;20;7;13;2023-04-05T22:45:00+02:00;Paris
Auguste Blanqui - Corvisart;26;22;4;4;0;2023-04-05T22:45:31+02:00;Paris
Square Louise Michel;36;23;12;2;10;2023-04-05T22:46:53+02:00;Paris
Clichy - Douai;32;29;1;0;1;2023-04-05T22:47:17+02:00;Paris
Mairie de Clamart;33;12;17;4;13;2023-04-05T22:44:11+02:00;Clamart
Esplanade du Foncet - Camille Desmoulins;28;14;14;14;0;2023-04-05T22:47:02+02:00;Issy-les-Moulineaux
Place Jeanne d'Arc;36;24;11;6;5;2023-04-05T22:45:37+02:00;Paris
Pont de Suresnes;24;24;0;0;0;2023-02-19T00:47:41+01:00;Suresnes
Douai - Pierre Fontaine;25;16;6;4;2;2023-04-05T22:46:40+02:00;Paris
Joseph Dijon - Ornano;37;14;20;13;7;2023-04-05T22:45:58+02:00;Paris
Bessières - Porte de Clichy;33;22;9;8;1;2023-04-05T22:44:37+02:00;Paris
Picpus - Louis Braille;44;30;12;11;1;2023-04-05T22:43:45+02:00;Paris
Portugais - Kléber;26;25;1;1;0;2023-04-05T22:46:56+02:00;Paris
Crozatier - Faubourg Saint-Antoine;42;5;30;27;3;2023-04-05T22:45:48+02:00;Paris
Halles - Bourdonnais;20;15;2;2;0;2023-04-05T22:43:52+02:00;Paris
Saint-Germain - Ciseaux;18;17;0;0;0;2023-04-05T22:46:39+02:00;Paris
Quai du Président Roosevelt - Pont Aval;30;30;0;0;0;2023-04-05T22:43:48+02:00;Paris
Rottembourg - Général Michel Bizot;43;20;22;19;3;2023-04-05T22:46:47+02:00;Paris
Delizy - Louis Nadot;22;19;1;0;1;2023-04-05T22:45:47+02:00;Pantin
Vivaldi - Antoine-Julien Hénard;27;26;1;1;0;2023-04-05T22:45:53+02:00;Paris
Saint-Mandé - Fabre d'Eglantine;34;30;4;0;4;2023-04-05T22:46:09+02:00;Paris
Marché Saint-Quentin;15;10;3;1;2;2023-04-05T22:45:21+02:00;Paris
Lemercier - Cardinet;24;1;23;16;7;2023-04-05T22:46:12+02:00;Paris
Louis Xavier de Ricard - Ancienne Mairie;34;25;5;2;3;2023-04-05T22:44:36+02:00;Fontenay-sous-Bois
Toqueville - Cardinet;33;22;10;5;5;2023-04-05T22:44:41+02:00;Paris
Lebrun - Colonel Fabien;27;24;3;1;2;2023-04-05T22:39:20+02:00;Vitry-sur-Seine
Suffren - Champ de Mars;23;12;11;9;2;2023-04-05T22:46:56+02:00;Paris
Place d'Italie - Vincent Auriol;40;24;15;4;11;2023-04-05T22:47:01+02:00;Paris
Centre Georges Pompidou;26;24;2;1;1;2023-04-05T22:39:42+02:00;Paris
Bagnolet - Orteaux;36;21;13;1;12;2023-04-05T22:40:35+02:00;Paris
Porte des Lilas - Faidherbe;39;29;7;0;7;2023-04-05T22:45:46+02:00;Les Lilas
Gare d'Argenteuil;40;13;24;14;10;2023-04-05T22:47:16+02:00;Argenteuil
Place Ginette Hamelin;51;26;24;23;1;2023-04-05T22:47:10+02:00;Paris
Mairie du 8ème;14;11;3;3;0;2023-04-05T22:45:02+02:00;Paris
Gare du Stade;20;3;16;14;2;2023-04-05T22:45:28+02:00;Colombes
Jules Guesdes - Général de Gaulle;24;14;10;5;5;2023-04-05T22:44:24+02:00;Issy-les-Moulineaux
Mstislav Rostropovitch - Berthier;18;16;2;2;0;2023-04-05T22:44:00+02:00;Paris
Bibliothèque Nationale - Richelieu;17;15;2;2;0;2023-04-05T22:44:43+02:00;Paris
Londres - Place d'Estienne d'Orves;25;23;0;0;0;2023-04-05T22:44:43+02:00;Paris
Marché Saint-Germain;21;17;1;0;1;2023-04-05T22:47:07+02:00;Paris
Dunkerque - Trudaine;16;12;3;3;0;2023-04-05T22:46:42+02:00;Paris
Cherche-Midi - Hôpital Necker;38;34;3;2;1;2023-04-05T22:46:03+02:00;Paris
Chemin de Bretagne;29;12;16;16;0;2023-04-05T22:47:08+02:00;Issy-les-Moulineaux
Place Aimé Césaire;27;24;3;0;3;2023-04-05T22:37:54+02:00;Clamart
Place Nelson Mandela;30;30;0;0;0;2023-04-05T22:37:39+02:00;Nanterre
Jean Monnet - Iles;32;11;17;13;4;2023-04-05T22:46:19+02:00;Issy-les-Moulineaux
Place Monge;21;13;6;3;3;2023-04-05T22:46:53+02:00;Paris
Parc Eli Lotar;20;4;15;4;11;2023-04-05T22:45:31+02:00;Aubervilliers
Square Denise Buisson;45;30;14;4;10;2023-04-05T22:47:05+02:00;Montreuil
Choisy - Tolbiac;26;15;1;0;1;2023-04-05T22:43:50+02:00;Paris
Glacière - Soeur Catherine Marie;40;30;10;9;1;2023-04-05T22:44:15+02:00;Paris
Marne - Charles de Gaulle;27;1;25;20;5;2023-04-05T22:46:52+02:00;Alfortville
Geoffroy - Marie;20;13;6;5;1;2023-04-05T22:46:35+02:00;Paris
Saint-Benoît - Jacob;23;17;3;1;2;2023-04-05T22:47:05+02:00;Paris
Place Joffre - Frédéric le Play;38;35;3;2;1;2023-04-05T22:38:25+02:00;Paris
Didot - Place de Moro-Giafferi;22;11;10;10;0;2023-04-05T22:42:03+02:00;Paris
Place de Rungis;32;1;31;27;4;2023-04-05T22:46:12+02:00;Paris
Davout - Volga;28;25;3;3;0;2023-04-05T22:44:04+02:00;Paris
Godot de Mauroy - Madeleine;22;18;0;0;0;2023-04-05T22:45:24+02:00;Paris
Porte de la Muette;36;34;2;0;2;2023-04-05T22:41:06+02:00;Paris
Madagascar - Meuniers;33;0;31;14;17;2023-04-05T22:43:08+02:00;Paris
Bruant - Vincent Auriol;25;23;1;1;0;2023-04-05T22:45:08+02:00;Paris
Vivienne - Montmartre;39;36;1;1;0;2023-04-05T22:45:59+02:00;Paris
Bréguet - Sabin;33;9;19;17;2;2023-04-05T22:46:43+02:00;Paris
Buffon - Jardin des Plantes;30;17;9;6;3;2023-04-05T22:39:03+02:00;Paris
Stalingrad - Rigollots;51;30;17;4;13;2023-04-05T22:45:07+02:00;Fontenay-sous-Bois
Charenton - Prague;26;3;21;20;1;2023-04-05T22:46:56+02:00;Paris
Gare du Nord - Saint-Vincent de Paul;24;21;2;2;0;2023-04-05T22:44:26+02:00;Paris
Square Etienne Jarousse;25;22;3;1;2;2023-04-05T22:45:37+02:00;Vanves
Raymond Poincaré - Place Victor Hugo;25;18;3;3;0;2023-04-05T22:41:43+02:00;Paris
Cloître Saint-Merri - Renard;32;26;3;1;2;2023-04-05T22:45:44+02:00;Paris
Paul Bodin - Clichy;34;20;12;10;2;2023-04-05T22:44:10+02:00;Paris
Champs-Elysees - Bassano;25;25;0;0;0;2021-02-21T20:09:18+01:00;Paris
Ecoles - Carmes;36;33;1;1;0;2023-04-05T22:45:00+02:00;Paris
Hôpital Necker;40;36;4;2;2;2023-04-05T22:45:58+02:00;Paris
Bourdon - Pont Morland;52;31;20;18;2;2023-04-05T22:46:45+02:00;Paris
Bourg l'Abbé - Saint-Martin;42;17;22;22;0;2023-04-05T22:46:59+02:00;Paris
Reuilly - Place Felix Eboue;42;21;17;8;9;2023-04-05T22:47:11+02:00;Paris
Abbé Groult - Convention;12;2;11;7;4;2023-04-05T22:46:24+02:00;Paris
Porte Molitor;60;35;21;18;3;2023-04-05T22:41:44+02:00;Paris
Richard Lenoir - Voltaire;25;1;24;22;2;2023-04-05T22:46:28+02:00;Paris
Charles Frérot - Albert Guilpin;30;3;24;16;8;2023-04-05T22:45:07+02:00;Gentilly
Gare RER - Malleret-Joinville;20;14;5;3;2;2023-04-05T22:46:50+02:00;Alfortville
Place de la Madeleine - Royale;26;22;3;2;1;2023-04-05T22:44:48+02:00;Paris
Hôtel de Ville de Sèvres;32;23;9;6;3;2023-04-05T22:45:41+02:00;Sèvres
Chevreuse - Montparnasse;15;13;2;0;2;2023-04-05T22:46:19+02:00;Paris
Condorcet - Turgot;20;16;4;2;2;2023-04-05T22:44:23+02:00;Paris
Gare RER les Grésillons;22;7;13;6;7;2023-04-05T22:43:43+02:00;Asnières-sur-Seine
Leredde - Tolbiac;44;36;6;4;2;2023-04-05T22:46:21+02:00;Paris
Cambon - Rivoli;40;35;2;1;1;2023-04-05T22:43:53+02:00;Paris
Villiers - Batignolles;23;19;1;0;1;2023-04-05T22:45:58+02:00;Paris
Jules Vallès - Charonne;23;9;12;11;1;2023-04-05T22:42:41+02:00;Paris
Place Charles Michels;37;4;31;27;4;2023-04-05T22:46:18+02:00;Paris
Sèvres - Lecourbe;62;57;4;0;4;2023-04-05T22:47:13+02:00;Paris
Croix Nivert - Square Saint-Lambert;47;1;45;34;11;2023-04-05T22:47:06+02:00;Paris
Perle - Vieille du Temple;36;30;4;2;2;2023-04-05T22:47:14+02:00;Paris
Benoît Frachon - République;30;26;4;0;4;2023-04-05T22:46:37+02:00;Paris
Epée de Bois - Mouffetard;63;56;6;5;1;2023-04-05T22:45:10+02:00;Paris
Jean Jaurès - Jules Jacquemin;24;15;9;1;8;2023-04-05T22:39:20+02:00;Le Pré-Saint-Gervais
Claude Vellefaux - Hôpital Saint-Louis;32;23;8;7;1;2023-04-05T22:46:43+02:00;Paris
Mairie du 14ème;32;24;8;6;2;2023-04-05T22:47:09+02:00;Paris
Cadix - Hameau;37;16;18;16;2;2023-04-05T22:46:59+02:00;Paris
Landy - Heurtault;30;4;24;11;13;2023-04-05T22:46:15+02:00;Aubervilliers
Camille Risch - Paul Armangot;25;17;8;2;6;2023-04-05T22:45:07+02:00;Vitry-sur-Seine
Paradis - Hauteville;31;20;9;7;2;2023-04-05T22:46:14+02:00;Paris
Reuilly - Daumesnil;36;13;20;12;8;2023-04-05T22:47:01+02:00;Paris
Jardins d'Eole;20;0;18;8;10;2023-04-05T22:46:13+02:00;Paris
Molitor - Michel-Ange;52;26;22;17;5;2023-04-05T22:40:21+02:00;Paris
Place des Droits de l'Enfant;24;1;22;9;13;2023-04-05T22:47:03+02:00;Paris
Charentonneau - Maisons Alfort;20;1;19;11;8;2023-04-05T22:40:53+02:00;Maisons-Alfort
Porte de Bagnolet;33;28;4;0;4;2023-04-05T22:47:04+02:00;Paris
Place des Abbesses;12;3;9;2;7;2023-04-05T22:45:05+02:00;Paris
Plantes - Moulin Vert;45;20;23;8;15;2023-04-05T22:41:56+02:00;Paris
Sorbier - Ménilmontant;24;9;14;1;13;2023-04-05T22:47:00+02:00;Paris
Crevaux - Bugeaud;31;30;1;1;0;2023-04-05T22:45:27+02:00;Paris
Mairie du 16ème;35;32;3;0;3;2023-04-05T22:42:08+02:00;Paris
Cité Riverin - Château d'Eau;18;6;6;5;1;2023-04-05T22:45:13+02:00;Paris
Pyrénées - Avron;32;24;8;5;3;2023-04-05T22:43:51+02:00;Paris
Flandrin - Longchamp;42;31;7;3;4;2023-04-05T22:41:39+02:00;Paris
Louis Lumière.;22;17;3;0;3;2023-04-05T22:42:53+02:00;Paris
Place de la Nation - Picpus;36;33;3;0;3;2023-04-05T22:41:59+02:00;Paris
Mairie d'Issy;41;17;24;21;3;2023-04-05T22:45:33+02:00;Issy-les-Moulineaux
Maxime Gorki - Louis Aragon;20;13;7;2;5;2023-04-05T22:45:18+02:00;Villejuif
Place de la Nation - Charonne;36;32;4;1;3;2023-04-05T22:45:12+02:00;Paris
Poissonniers - Championnet;28;14;4;1;3;2023-04-05T22:43:27+02:00;Paris
Beaubourg - Michel-le-Comte;17;11;4;3;1;2023-04-05T22:42:02+02:00;Paris
Grande Truanderie - Saint-Denis;33;26;4;4;0;2023-04-05T22:46:34+02:00;Paris
Niger - Soult;24;18;5;4;1;2023-04-05T22:45:33+02:00;Paris
Square Claude Bernard;30;29;1;0;1;2023-04-05T22:46:02+02:00;Paris
Parme - Clichy;24;21;2;1;1;2023-04-05T22:44:57+02:00;Paris
Henri Ravera - Gabriel Péri;30;24;5;0;5;2023-04-05T22:45:53+02:00;Bagneux
Petit - Georges Thill;23;5;17;9;8;2023-04-05T22:42:11+02:00;Paris
Gare Montparnasse - Arrivée;43;40;2;2;0;2023-04-05T22:39:44+02:00;Paris
Chausson - Gabriel Péri;22;3;18;6;12;2023-04-05T22:46:38+02:00;Gennevilliers
Roger Salengro - Général de Gaulle;27;3;23;20;3;2023-04-05T22:45:10+02:00;Champigny-sur-Marne
Pyrénées - Plaine;12;7;5;2;3;2023-04-05T22:46:05+02:00;Paris
Murat - Porte de Saint-Cloud;38;9;26;21;5;2023-04-05T22:46:19+02:00;Paris
Gare de Bellevue;20;14;6;0;6;2023-04-05T22:40:41+02:00;Meudon
Diane Arbus;38;31;4;1;3;2023-04-05T22:46:49+02:00;Paris
Beaumarchais - Saint-Gilles;51;25;25;24;1;2023-04-05T22:43:18+02:00;Paris
Phalsbourg - Villiers;20;16;3;0;3;2023-04-05T22:46:29+02:00;Paris
Charenton - Jardiniers;31;0;29;17;12;2023-04-05T22:45:24+02:00;Paris
Cité Vaneau;26;20;5;3;2;2023-04-05T22:42:53+02:00;Paris
Sarrette - Général Leclerc;22;16;6;3;3;2023-04-05T22:46:25+02:00;Paris
Maine - Liancourt;27;23;3;0;3;2023-04-05T22:44:16+02:00;Paris
Place de la Fraternité;22;4;14;4;10;2023-04-05T22:46:38+02:00;Montreuil
Leibniz - Jean Dollfus;32;11;21;14;7;2023-04-05T22:47:06+02:00;Paris
Turbigo - Réaumur;31;16;12;12;0;2023-04-05T22:46:58+02:00;Paris
Herschel - Observatoire;37;35;2;0;2;2023-04-05T22:46:48+02:00;Paris
Dunkerque - Alsace;20;18;2;2;0;2023-04-05T22:44:36+02:00;Paris
Gare de Reuilly - Picpus;28;14;13;7;6;2023-04-05T22:46:38+02:00;Paris
Mairie du 10ème;19;10;7;7;0;2023-04-05T22:45:44+02:00;Paris
Pergolèse - Marbeau;27;17;2;1;1;2023-04-05T22:41:03+02:00;Paris
Faubourg Du Temple - Republique;38;28;6;6;0;2023-04-05T22:46:57+02:00;Paris
Jourdan - Cité Universitaire;39;36;1;1;0;2023-04-05T22:46:49+02:00;Paris
Petites Ecuries - Faubourg Saint-Denis;29;20;8;7;1;2023-04-05T22:47:02+02:00;Paris
Gambetta - Père Lachaise;29;18;11;1;10;2023-04-05T22:43:13+02:00;Paris
Charles de Gaulle - Plateau de Vanves;33;31;1;0;1;2023-04-05T22:41:29+02:00;Malakoff
Porte de Clignancourt - Ney;40;23;13;1;12;2023-04-05T22:46:10+02:00;Paris
Maurice Payret-Dortail;22;11;10;1;9;2023-04-05T22:43:31+02:00;Suresnes
Quai de Béthune - Pont de la Tournelle;25;11;12;11;1;2023-04-05T22:44:01+02:00;Paris
Française - Etienne Marcel;37;32;0;0;0;2023-04-05T22:46:47+02:00;Paris
Turbigo - Française;16;12;0;0;0;2023-04-05T22:46:44+02:00;Paris
Saint-Michel - Luxembourg;29;28;0;0;0;2023-04-05T22:45:37+02:00;Paris
Cordelières - Arago;46;9;35;26;9;2023-04-05T22:47:09+02:00;Paris
Nationale - Vincent Auriol;33;32;1;0;1;2023-04-05T22:41:37+02:00;Paris
Centquatre;42;31;9;5;4;2023-04-05T22:45:43+02:00;Paris
Olivier de Serres - Leriche;25;2;22;7;15;2023-04-05T22:45:15+02:00;Paris
Square Montholon;21;7;13;12;1;2023-04-05T22:46:20+02:00;Paris
Sainte-Elisabeth - Turbigo;33;5;22;19;3;2023-04-05T22:46:29+02:00;Paris
Gare Saint-Lazare - Stockholm;32;26;3;2;1;2023-04-05T22:40:55+02:00;Paris
Solitaires - Place des Fêtes;29;25;4;0;4;2023-04-05T22:40:11+02:00;Paris
Louis Blanc - La Chapelle;21;7;13;6;7;2023-04-05T22:45:16+02:00;Paris
Adolphe Lalyre - Armand Silvestre;40;23;16;9;7;2023-04-05T22:42:21+02:00;Courbevoie
Emile Reynaud - Porte de la Villette;22;0;21;10;11;2023-04-05T22:46:24+02:00;Paris
Temple - Haudriettes;19;12;6;6;0;2023-04-05T22:45:05+02:00;Paris
Bargue -  Dutot;21;10;11;7;4;2023-04-05T22:45:43+02:00;Paris
Bézout - Général Leclerc;30;25;5;4;1;2023-04-05T22:46:58+02:00;Paris
Place de l'Europe - Alfortville;24;8;16;9;7;2023-04-05T22:42:47+02:00;Alfortville
Blancs-Manteaux - Archives;29;22;4;4;0;2023-04-05T22:47:10+02:00;Paris
Traktir - Foch;22;18;1;1;0;2023-04-05T22:45:58+02:00;Paris
Hôtel de Ville d'Asnières sur Seine;30;1;25;19;6;2023-04-05T22:44:37+02:00;Asnières-sur-Seine
Sèvres - Général Leclerc;30;16;14;8;6;2023-04-05T22:47:03+02:00;Boulogne-Billancourt
Hôtel de Ville de Chaville;20;16;3;0;3;2023-04-05T22:40:35+02:00;Chaville
Louis le Grand - Italiens;33;28;2;1;1;2023-04-05T22:38:49+02:00;Paris
Didot - Mariniers;35;15;20;11;9;2023-04-05T22:46:36+02:00;Paris
Saint-Denis - Université;24;21;3;0;3;2023-04-05T22:47:12+02:00;Saint-Denis
Lally-Tollendal - Armand Carrel;28;15;12;6;6;2023-04-05T22:40:20+02:00;Paris
Bourse du Travail;17;11;4;2;2;2023-04-05T22:47:00+02:00;Paris
Gardenat-Lapostol - Velettes;20;18;2;1;1;2023-04-05T22:46:21+02:00;Suresnes
Bosquet - Saint-Dominique;28;13;12;11;1;2023-04-05T22:47:11+02:00;Paris
Place du 17 Octobre;20;7;11;9;2;2023-04-05T22:44:34+02:00;Gennevilliers
Maurice d'Ocagne - General Maudhuy;30;28;2;0;2;2023-04-05T22:43:24+02:00;Paris
Kléber - National;20;13;4;3;1;2023-04-05T22:45:52+02:00;La Garenne-Colombes
Arsène Houssaye - Champs-Elysées;29;24;0;0;0;2023-04-05T22:44:35+02:00;Paris
Château - République;20;5;14;7;7;2023-04-05T22:44:56+02:00;La Garenne-Colombes
Lacuée - Lyon;16;7;7;4;3;2023-04-05T22:46:53+02:00;Paris
Victoire - Laffitte;20;18;0;0;0;2023-04-05T22:46:44+02:00;Paris
Archives - Rivoli;25;20;1;0;1;2023-04-05T22:45:46+02:00;Paris
Eugène Varlin - Place de la Paix;23;20;3;1;2;2023-04-05T22:37:52+02:00;Villejuif
Frères Flavien - Porte des Lilas;23;8;15;0;15;2023-04-05T22:44:31+02:00;Paris
Froidevaux - Boulard;35;31;2;2;0;2023-04-05T22:46:19+02:00;Paris
Saint-Denis - Réaumur;32;18;11;9;2;2023-04-05T22:45:26+02:00;Paris
Place de l'Hôtel de Ville;14;9;1;1;0;2023-04-05T22:46:33+02:00;Paris
Joffre - Aigle;20;10;9;4;5;2023-04-05T22:41:50+02:00;La Garenne-Colombes
Verdier - Jean Jaurès;33;23;10;4;6;2023-04-05T22:43:59+02:00;Montrouge
Parc Roger Salengro;35;16;19;13;6;2023-04-05T22:42:15+02:00;Clichy
Alouettes - Maréchal de Lattre de Tassigny;22;20;2;0;2;2023-04-05T22:47:15+02:00;Fontenay-sous-Bois
Etienne Marcel - Montorgueil;28;23;5;5;0;2023-04-05T22:44:50+02:00;Paris
Mairie du Kremlin-Bicêtre;25;18;6;0;6;2023-04-05T22:45:18+02:00;Le Kremlin-Bicêtre
Montmartre - Etienne Marcel;16;11;3;3;0;2023-04-05T22:45:36+02:00;Paris
Séminaire de Conflans - Liberté;26;17;8;3;5;2023-04-05T22:42:42+02:00;Charenton-le-Pont
Cléry - Montmartre;44;37;3;2;1;2023-04-05T22:47:12+02:00;Paris
Poulet - Barbès;0;0;0;0;0;2019-03-20T15:46:36+01:00;Paris
Square Emile - Chautemps;25;17;3;0;3;2023-04-05T22:45:13+02:00;Paris
Gare du Nord - La Chapelle;18;16;1;1;0;2023-04-05T22:37:20+02:00;Paris
Gare d'Austerlitz - Pont Charles de Gaulle;55;52;1;0;1;2023-04-05T22:46:43+02:00;Paris
Gardenat Lapostol - Franklin Roosevelt;24;21;3;0;3;2023-04-05T22:47:05+02:00;Suresnes
Cours de Vincennes - Soult;45;41;2;1;1;2023-04-05T22:46:44+02:00;Paris
Jean-Jacques Rousseau - Deux Ecus;22;17;2;2;0;2023-04-05T22:45:07+02:00;Paris
Lagny - Auguste Blanqui;27;24;2;1;1;2023-04-05T22:42:42+02:00;Montreuil
Candale - Mehul;25;15;10;2;8;2023-04-05T22:45:01+02:00;Pantin
Adolphe Pinard - Victor Hugo;52;44;8;3;5;2023-04-05T22:46:49+02:00;Malakoff
Édouard Vaillant - Place Jean Jaurès;24;7;16;1;15;2023-04-05T22:43:52+02:00;Suresnes
Mairie du 3ème;32;8;18;17;1;2023-04-05T22:46:55+02:00;Paris
Choisy - Malmaisons;25;13;9;8;1;2023-04-05T22:46:20+02:00;Paris
Convention - Lourmel;36;0;34;31;3;2023-04-05T22:46:28+02:00;Paris
Mairie du 2ème;28;26;1;0;1;2023-04-05T22:45:11+02:00;Paris
Bastille - Beaumarchais;23;1;19;17;2;2023-04-05T22:46:22+02:00;Paris
Place du 8 mai 1945;30;12;14;6;8;2023-04-05T22:45:45+02:00;Saint-Denis
Fille du Calvaire - Turenne;29;14;13;10;3;2023-04-05T22:45:19+02:00;Paris
Place du Lieutenant Henri Karcher;30;27;2;1;1;2023-04-05T22:46:49+02:00;Paris
Cesaria Evora - Rosa Parks;40;36;3;1;2;2023-04-05T22:47:16+02:00;Paris
Grande Rue - Europe;25;18;7;2;5;2023-04-05T22:44:35+02:00;Sèvres
Place de la Bastille - Bourdon;35;8;25;24;1;2023-04-05T22:46:35+02:00;Paris
Saint-Bon - Rivoli;19;16;2;2;0;2023-04-05T22:46:28+02:00;Paris
Tiron - Rivoli;28;11;11;10;1;2023-04-05T22:44:05+02:00;Paris
Stade Pershing;26;26;0;0;0;2023-02-10T14:22:59+01:00;Paris
Jean Bleuzen - Square du 11 Novembre;49;44;5;0;5;2023-04-05T22:41:50+02:00;Vanves
Filles Saint-Thomas - Place de la Bourse;58;58;0;0;0;2023-04-05T22:43:48+02:00;Paris
Place de la République - Temple;18;11;5;4;1;2023-04-05T22:47:01+02:00;Paris
Saint-Amand - Labrouste;36;4;30;13;17;2023-04-05T22:46:03+02:00;Paris
Rivoli - Musée du Louvre;24;20;2;1;1;2023-04-05T22:46:57+02:00;Paris
Fabre d'Eglantine - Place de la Nation;68;49;17;16;1;2023-04-05T22:44:33+02:00;Paris
Village Saint-Paul;28;16;11;10;1;2023-04-05T22:47:12+02:00;Paris
Jouffroy d'Abbans - Villiers;34;30;1;1;0;2023-04-05T22:45:44+02:00;Paris
Quai Jules Guesde - Saint-Simon;30;10;19;14;5;2023-04-05T22:46:54+02:00;Vitry-sur-Seine
Marx Dormoy - Château Sainte-Barbe;22;16;6;1;5;2023-04-05T22:44:39+02:00;Fontenay-aux-Roses
Bas - Gabriel Péri;30;22;6;3;3;2023-04-05T22:46:14+02:00;Asnières-sur-Seine
Amédée Huon - Fort d'Ivry;31;26;3;0;3;2023-04-05T22:39:35+02:00;Ivry-sur-Seine
Barbès - Monique Maunoury;40;32;7;3;4;2023-04-05T22:46:05+02:00;Ivry-sur-Seine
Saint-Honoré - Musée du Louvre;22;22;0;0;0;2023-04-05T22:47:04+02:00;Paris
Choiseul - Quatre Septembre;44;41;2;1;1;2023-04-05T22:46:46+02:00;Paris
Archives - Pastourelle;28;13;15;11;4;2023-04-05T22:46:58+02:00;Paris
Porte de Saint Cloud - Parc des Princes;32;10;21;20;1;2023-04-05T22:47:01+02:00;Paris
Arthur Ranc - Hôpital Bichat;26;20;5;1;4;2023-04-05T22:46:53+02:00;Paris
Mairie du 4ème;44;28;10;9;1;2023-04-05T22:43:28+02:00;Paris
Magenta - Chabrol;24;15;7;4;3;2023-04-05T22:45:53+02:00;Paris
Hippodrome Paris-Vincennes;42;40;2;1;1;2023-04-05T22:42:02+02:00;Paris
Suresnes - Muette à Neuilly;30;25;5;2;3;2023-04-05T22:43:17+02:00;Paris
Saint-Gilles - Turenne;18;6;5;5;0;2023-04-05T22:44:50+02:00;Paris
Verdun - Carnot;28;4;23;4;19;2023-04-05T22:44:07+02:00;Ivry-sur-Seine
Pau Casals - Neuve Tolbiac;53;51;2;0;2;2023-04-05T22:44:47+02:00;Paris
Marseillaise - Grenade;0;0;0;0;0;2023-01-17T06:58:51+01:00;Paris
Square Pierre Lazareff;17;14;3;3;0;2023-04-05T22:46:04+02:00;Paris
Place du Palais Royal;67;67;0;0;0;2023-04-05T22:39:23+02:00;Paris
Place Paul Delouvrier;26;6;19;15;4;2023-04-05T22:45:43+02:00;Paris
Belles Feuilles - Place de Mexico;23;22;1;0;1;2023-04-05T22:45:13+02:00;Paris
Alger - Rivoli;21;19;1;0;1;2023-04-05T22:46:26+02:00;Paris
Lampes;43;23;18;11;7;2023-04-05T22:44:03+02:00;Ivry-sur-Seine
Aboukir - Alexandrie;21;6;12;11;1;2023-04-05T22:46:11+02:00;Paris
Porte de Pantin.;33;23;8;6;2;2023-04-05T22:46:48+02:00;Paris
Waldeck Rochet - Germaine Tillon;31;27;3;0;3;2023-04-05T22:43:57+02:00;Aubervilliers
Jules Guesdes - Carnot;16;7;6;3;3;2023-04-05T22:43:26+02:00;Saint-Denis
Chaussée d'Antin - Haussmann;24;22;0;0;0;2023-04-05T22:45:50+02:00;Paris
Les Halles - Saint-Eustache;32;27;2;1;1;2023-04-05T22:46:25+02:00;Paris
Gare des Vallées;20;2;13;1;12;2023-04-05T22:47:08+02:00;La Garenne-Colombes
Victor Massé - Jean-Baptiste Pigalle;18;7;8;5;3;2023-04-05T22:45:57+02:00;Paris
Oratoire - Rivoli;18;12;2;1;1;2023-04-05T22:47:06+02:00;Paris
Coquillière - Louvre;21;20;1;1;0;2023-04-05T22:46:25+02:00;Paris
Château - Place de Catalogne;33;32;1;0;1;2023-04-05T22:45:38+02:00;Paris
Place de l'Eglise - Vitry-sur-Seine;28;2;24;23;1;2023-04-05T22:43:55+02:00;Vitry-sur-Seine
Ventadour - Opéra;27;26;1;0;1;2023-04-05T22:42:42+02:00;Paris
Sorbier - Gasnier-Guy;34;16;17;1;16;2023-04-05T22:45:46+02:00;Paris
Custine - Ramey;41;6;32;11;21;2023-04-05T22:46:56+02:00;Paris
Saint-Mande - Picpus;35;22;12;9;3;2023-04-05T22:39:15+02:00;Paris
Berthier - Porte de Clichy;24;17;6;3;3;2023-04-05T22:45:57+02:00;Paris
Les Blagis;27;7;19;15;4;2023-04-05T22:47:13+02:00;Sceaux
Saint Pères - Saint Germain;0;0;0;0;0;2023-01-19T09:32:29+01:00;Paris
Victor Hugo - Paul Eluard;32;13;19;16;3;2023-04-05T22:46:59+02:00;Charenton-le-Pont
Square Victor Basch;20;7;11;4;7;2023-04-05T22:45:07+02:00;Colombes
Youri Gagarine - Commune de Paris;33;23;10;1;9;2023-04-05T22:47:02+02:00;Vitry-sur-Seine
Saint-Honoré - 29 juillet;20;18;0;0;0;2023-04-05T22:43:25+02:00;Paris
Quai de Sèvres - Manufacture Nationale;28;7;17;15;2;2023-04-05T22:45:43+02:00;Sèvres
Saint-Placide - Cherche Midi;66;57;8;4;4;2023-04-05T22:44:23+02:00;Paris
Bagnolet - Place Saint-Blaise;28;18;10;0;10;2023-04-05T22:45:29+02:00;Paris
Decrès - Alésia;0;0;0;0;0;2023-03-01T13:01:35+01:00;Paris
Dutot - Place Alleray;56;31;25;11;14;2023-04-05T22:46:11+02:00;Paris
Guy Môquet - Parvis Georges Marchais;30;23;6;0;6;2023-04-05T22:45:44+02:00;Villejuif
Henri Barbusse - Gabriel Péri;27;19;8;2;6;2023-04-05T22:46:45+02:00;Châtillon
Le Goff - Gay-Lussac;35;31;2;1;1;2023-04-05T22:46:22+02:00;Paris
Stéphanie Bouvard - Gambetta;0;0;0;0;0;2022-11-03T10:26:33+01:00;Ivry-sur-Seine
Résistance - Parmentier;35;31;4;0;4;2023-04-05T22:41:49+02:00;Montreuil
Vincent Auriol - Louise Weiss;22;20;1;1;0;2023-04-05T22:47:10+02:00;Paris
Jean Jaurès - Paul Lafargue;28;24;3;3;0;2023-04-05T22:43:20+02:00;Puteaux
Halle Freyssinet - Parvis Alan Turing;23;23;0;0;0;2023-04-05T22:41:32+02:00;Paris
Quai de l'Aisne - Général Leclerc;27;3;21;11;10;2023-04-05T22:46:58+02:00;Pantin
Bichat - Grange aux Belles;30;16;12;11;1;2023-04-05T22:46:32+02:00;Paris
Parc Départemental des Hautes-Bruyères;30;28;1;0;1;2023-04-05T22:47:13+02:00;Villejuif
Gare de Chaville Rive Gauche;18;10;6;4;2;2023-04-05T22:47:12+02:00;Chaville
Victor Hugo - Gare;22;4;17;6;11;2023-04-05T22:43:22+02:00;Colombes
Gobelins - Port-Royal;40;2;34;30;4;2023-04-05T22:47:15+02:00;Paris
Parc Floral du Bel Air;25;24;0;0;0;2023-04-05T22:46:16+02:00;Paris
Danielle Casanova - Ledru-Rollin;28;1;26;22;4;2023-04-05T22:46:53+02:00;Ivry-sur-Seine
Bréa - Raspail;24;21;0;0;0;2023-04-05T22:46:37+02:00;Paris
Belleville -  Pré Saint-Gervais;21;3;18;0;18;2023-04-05T22:46:10+02:00;Paris
Henri Barbusse - Marcel Cachin;37;37;0;0;0;2023-01-18T11:56:20+01:00;Saint-Denis
Ney - Porte de Montmartre;24;18;3;0;3;2023-04-05T22:45:26+02:00;Paris
Place de la Division Leclerc;35;34;1;0;1;2023-04-05T22:37:59+02:00;Fontenay-aux-Roses
Saint-Denis - Rivoli;43;26;14;11;3;2023-04-05T22:47:03+02:00;Paris
Cardinal Lavigerie;46;25;19;9;10;2023-04-05T22:45:49+02:00;Paris
Gare - Aristide Briand;29;4;22;21;1;2023-04-05T22:46:36+02:00;Issy-les-Moulineaux
Réaumur - Montmartre;19;18;1;0;1;2023-04-05T22:45:09+02:00;Paris
Porte de Versailles;28;23;1;1;0;2023-04-05T22:46:52+02:00;Paris
Belfort - Victor Hugo;24;10;13;7;6;2023-04-05T22:45:48+02:00;Clichy
Carrefour Pleyel;36;31;4;4;0;2023-04-05T22:42:45+02:00;Saint-Denis
André Theuriet - Blagis;30;21;7;6;1;2023-04-05T22:46:49+02:00;Bourg-la-Reine
Bons Raisins - Voltaire;24;15;9;0;9;2023-04-05T22:46:04+02:00;Rueil-Malmaison
Saint-Marc - Feydeau;37;34;2;2;0;2023-04-05T22:43:13+02:00;Paris
Place Denfert-Rochereau;20;1;19;15;4;2023-04-05T22:46:31+02:00;Boulogne-Billancourt
Place André Malraux;19;14;1;1;0;2023-04-05T22:47:05+02:00;Paris
Saint-Augustin;31;29;0;0;0;2023-04-05T22:46:43+02:00;Paris
Place des Victoires;24;23;1;0;1;2023-04-05T22:46:05+02:00;Paris
Bobillot - Tolbiac;33;12;20;14;6;2023-04-05T22:46:02+02:00;Paris
Danielle Casanova - Opéra;20;16;0;0;0;2023-04-05T22:42:47+02:00;Paris
Général Leclerc - Bièvre;25;15;10;6;4;2023-04-05T22:44:04+02:00;Bourg-la-Reine
Simon Bolivar - Henri Turot;22;15;6;0;6;2023-04-05T22:47:15+02:00;Paris
Félix Faure - Convention;44;1;37;34;3;2023-04-05T22:43:08+02:00;Paris
Silly - Louis Blériot;23;2;20;16;4;2023-04-05T22:45:29+02:00;Boulogne-Billancourt
Léon Frot - Charonne;19;0;17;13;4;2023-04-05T22:47:05+02:00;Paris
Place du Moulin de Javel;45;42;1;0;1;2023-04-05T22:46:25+02:00;Paris
Duméril - Jeanne d'Arc;40;7;31;18;13;2023-04-05T22:46:05+02:00;Paris
Blanqui - Docteur Bauer;28;3;22;15;7;2023-04-05T22:47:03+02:00;Saint-Ouen-sur-Seine
Cambronne - Mademoiselle;67;2;64;48;16;2023-04-05T22:46:50+02:00;Paris
Strasbourg - Saint-Denis;16;8;6;6;0;2023-04-05T22:45:49+02:00;Paris
Euryale Dehaynin - Loire;30;23;3;1;2;2023-04-05T22:46:35+02:00;Paris
Paganini - Davout;22;17;2;2;0;2023-04-05T22:40:15+02:00;Paris
Pyrénées - Cours de Vincennes;21;13;8;8;0;2023-04-05T22:47:16+02:00;Paris
Stalingrad - Henri Luisette;26;24;2;0;2;2023-04-05T22:41:14+02:00;Villejuif
Hôtel de Ville de Saint-Ouen;48;16;27;14;13;2023-04-05T22:45:46+02:00;Saint-Ouen-sur-Seine
Gare de Robinson;30;19;11;6;5;2023-04-05T22:45:44+02:00;Sceaux
Suffren - La Motte-Piquet;23;16;4;2;2;2023-04-05T22:45:07+02:00;Paris
Gare RER - Maurice Grandcoing;37;6;31;25;6;2023-04-05T22:46:03+02:00;Ivry-sur-Seine
Dôme - République;25;8;13;11;2;2023-04-05T22:46:54+02:00;Boulogne-Billancourt
Jardin Modèle - Pierre Boudou;18;1;14;8;6;2023-04-05T22:43:39+02:00;Asnières-sur-Seine
Taitbout - Châteaudun;39;37;1;1;0;2023-04-05T22:46:48+02:00;Paris
Jouffroy d'Abbans - Malesherbes;27;22;1;0;1;2023-04-05T22:44:38+02:00;Paris
Riquet - Marx Dormoy;29;3;22;4;18;2023-04-05T22:43:40+02:00;Paris
République - Louis Loucheur;37;12;25;12;13;2023-04-05T22:46:34+02:00;Champigny-sur-Marne
Franquet - Labrouste;37;17;19;16;3;2023-04-05T22:46:31+02:00;Paris
Mariotte - Batignolles;20;20;0;0;0;2022-12-05T09:45:14+01:00;Paris
Roquette - Auguste Laurent;16;1;15;14;1;2023-04-05T22:47:07+02:00;Paris
André Mazet - Saint-André des Arts;55;25;27;27;0;2023-04-05T22:46:10+02:00;Paris
Gergovie - Alésia;36;29;6;5;1;2023-04-05T22:46:18+02:00;Paris
Saint-Fiacre - Poissonière;35;32;1;1;0;2023-04-05T22:47:13+02:00;Paris
LCL Campus - Place Oscar Niemeyer;37;20;15;3;12;2023-04-05T22:46:53+02:00;Villejuif
Béranger - Félix Faure;28;10;17;5;12;2023-04-05T22:42:48+02:00;Châtillon
Général De Gaulle - Vivien;22;5;17;3;14;2023-04-05T22:44:55+02:00;Saint-Mandé
Mûriers - Père Lachaise;20;13;7;2;5;2023-04-05T22:41:33+02:00;Paris
Pierre Joseph Desault;19;1;16;10;6;2023-04-05T22:45:46+02:00;Paris
Place du Maréchal de Lattre de Tassigny;27;1;23;15;8;2023-04-05T22:42:13+02:00;Vanves
Guillaume Tell - Parc Henri Barbusse;20;14;5;2;3;2023-04-05T22:45:37+02:00;Pantin
Martyrs de Châteaubriant - Jean Grandel;38;32;5;5;0;2023-04-05T22:45:20+02:00;Argenteuil
Hector Malot - Daumesnil;54;6;47;46;1;2023-04-05T22:47:12+02:00;Paris
Place Charles de Gaulle;24;21;3;0;3;2023-04-05T22:46:35+02:00;Ville-d'Avray
Hôtel de Ville de Vincennes;27;24;3;2;1;2023-04-05T22:42:09+02:00;Vincennes
Clef des Champs - Albert Dhalenne;28;13;7;4;3;2023-04-05T22:43:34+02:00;Saint-Ouen-sur-Seine
Gambetta - Tourelles;20;0;0;0;0;2023-04-05T11:51:12+02:00;Paris
Madeleine Vionnet;34;31;7;1;6;2023-04-05T22:47:07+02:00;Aubervilliers
Hispano Suiza - Parc des Bruyères;30;5;23;17;6;2023-04-05T22:44:49+02:00;Bois-Colombes
Manin - Secrétan;20;17;1;0;1;2023-04-05T22:47:02+02:00;Paris
Dominique Pado - Croix Nivert;22;5;15;14;1;2023-04-05T22:46:02+02:00;Paris
Château de Vincennes;52;41;9;7;2;2023-04-05T22:46:16+02:00;Paris
Olympiades;36;24;10;4;6;2023-04-05T22:45:55+02:00;Paris
Mathis - Flandre;55;39;15;8;7;2023-04-05T22:43:52+02:00;Paris
Maine - Jean Zay;50;44;5;3;2;2023-04-05T22:47:17+02:00;Paris
Pierre Charron - Champs-Elysées;32;28;1;0;1;2023-04-05T22:44:39+02:00;Paris
Assas - Rennes;32;31;1;0;1;2023-04-05T22:45:01+02:00;Paris
Paix - Verdun;35;23;11;2;9;2023-04-05T22:45:41+02:00;Courbevoie
Tombe Issoire - René Coty;36;24;12;5;7;2023-04-05T22:46:49+02:00;Paris
Chevaleret - Louise Weiss;35;30;3;2;1;2023-04-05T22:46:06+02:00;Paris
Siam - La Pompe;16;9;6;3;3;2023-04-05T22:47:16+02:00;Paris
Balzac - Champs Elysées;30;29;1;0;1;2023-04-05T22:44:04+02:00;Paris
George Sand - Jean de La Fontaine;29;2;25;22;3;2023-04-05T22:46:08+02:00;Paris
Place du Docteur Yersin;50;47;3;0;3;2023-04-05T22:37:44+02:00;Paris
Charonne - Alexandre Dumas;35;16;18;6;12;2023-04-05T22:46:51+02:00;Paris
Dom-Pérignon - Gravelle;50;38;11;4;7;2023-04-05T22:44:21+02:00;Paris
Bourdonnais - Tour Eiffel;60;33;22;22;0;2023-04-05T22:44:56+02:00;Paris
Maxime Gorki - Paul Vaillant-Couturier;20;8;12;2;10;2023-04-05T22:44:19+02:00;Villejuif
Marcel Pourtout - Édouard Manet;24;5;18;11;7;2023-04-05T22:43:21+02:00;Rueil-Malmaison
Francoeur - Caulaincourt;34;10;20;4;16;2023-04-05T22:47:10+02:00;Paris
René Coty - Place Denfert-Rochereau;36;26;10;5;5;2023-04-05T22:39:51+02:00;Paris
Lecourbe - Convention;46;2;43;33;10;2023-04-05T22:46:55+02:00;Paris
Duhamel - André Gide;20;15;4;0;4;2023-04-05T22:42:52+02:00;Paris
Hauteville - Bonne Nouvelle;17;15;2;1;1;2023-04-05T22:46:02+02:00;Paris
Mairie de Bagnolet;28;28;0;0;0;2023-04-05T22:40:16+02:00;Bagnolet
Place de la vache noire;25;22;2;0;2;2023-04-05T22:47:00+02:00;Arcueil
Marceau - Président Wilson;32;25;3;2;1;2023-04-05T22:46:30+02:00;Paris
Place Charles Digeon;32;14;16;6;10;2023-04-05T22:46:14+02:00;Saint-Mandé
Legendre - Nollet;30;11;18;16;2;2023-04-05T22:46:36+02:00;Paris
Gouthière - Poterne des Peupliers;33;23;9;7;2;2023-04-05T22:44:29+02:00;Paris
Rome - Provence;30;28;1;0;1;2023-04-05T22:45:48+02:00;Paris
Place de la Nation - Taillebourg;47;43;4;4;0;2023-04-05T22:43:53+02:00;Paris
Gabriel Péri - Place de la Libération;18;7;11;4;7;2023-04-05T22:42:48+02:00;Montrouge
Port Royal - Hôpital Cochin;23;19;2;1;1;2023-04-05T22:41:39+02:00;Paris
Rampal - Belleville;17;6;9;6;3;2023-04-05T22:47:12+02:00;Paris
Place Eustache Deschamps;20;0;19;12;7;2023-04-05T22:44:54+02:00;Cachan
Verdier - République;29;22;7;2;5;2023-04-05T22:43:52+02:00;Montrouge
Moscou - Edouard Vaillant;30;27;1;0;1;2023-04-05T22:41:07+02:00;Bobigny
Louis Blanc - Aqueduc;37;19;13;6;7;2023-04-05T22:47:15+02:00;Paris
Buzenval - Vignoles;17;7;10;4;6;2023-04-05T22:47:00+02:00;Paris
Philippe-Auguste;48;42;4;4;0;2023-04-05T22:43:09+02:00;Paris
Edouard Pailleron - Bouret;27;26;0;0;0;2023-04-05T22:37:37+02:00;Paris
Bois de Vincennes - Polygone;51;41;9;8;1;2023-04-05T22:43:48+02:00;Paris
Pyrénées - Charles Renouvier;29;20;9;1;8;2023-04-05T22:41:55+02:00;Paris
Colonel Pierre Avia;29;22;5;3;2;2023-04-05T22:46:26+02:00;Paris
Bercy - Traversiére;30;21;7;5;2;2023-04-05T22:43:35+02:00;Paris
Regard - Rennes;46;40;4;3;1;2023-04-05T22:44:58+02:00;Paris
Edith Cavell - Volta;33;15;18;9;9;2023-04-05T22:46:54+02:00;Courbevoie
Ménilmontant - Oberkampf;40;13;23;9;14;2023-04-05T22:46:09+02:00;Paris
Square des Amandiers;12;9;2;1;1;2023-04-05T22:42:47+02:00;Paris
Lorraine - Jean Jaurès;19;9;10;8;2;2023-04-05T22:47:02+02:00;Paris
Jean de la Fontaine - Boulainvilliers;68;49;15;14;1;2023-04-05T22:43:56+02:00;Paris
Volontaires - Vaugirard;34;20;14;12;2;2023-04-05T22:45:26+02:00;Paris
Pereire - Saussure;32;24;7;4;3;2023-04-05T22:46:59+02:00;Paris
M.- A. Lagroua Weill-Hallé -  F. Dolto;60;57;3;3;0;2023-04-05T22:47:14+02:00;Paris
Marcadet - Ramey;21;4;16;6;10;2023-04-05T22:40:34+02:00;Paris
Victor Hugo - Bineau;25;21;4;4;0;2023-04-05T22:42:03+02:00;Neuilly-sur-Seine
Alexandre Dumas - Place de la Réunion;45;28;14;4;10;2023-04-05T22:44:48+02:00;Paris
Mairie du 20ème;27;23;4;0;4;2023-04-05T22:44:42+02:00;Paris
Porte de la Plaine;35;23;11;2;9;2023-04-05T22:42:53+02:00;Paris
Dantzig - Lefebvre;33;30;3;1;2;2023-04-05T22:41:21+02:00;Paris
Sahel - Général Michel Bizot;33;19;12;9;3;2023-04-05T22:45:13+02:00;Paris
Montparnasse -  Square Ozanam;49;48;0;0;0;2023-04-05T22:46:58+02:00;Paris
Ancienne Mairie - André Morizet;25;8;17;15;2;2023-04-05T22:47:07+02:00;Boulogne-Billancourt
Jean Bologne - Passy;19;16;1;1;0;2023-04-05T22:43:42+02:00;Paris
Jean Jaurès - Place de la Libération;30;25;5;1;4;2023-04-05T22:45:55+02:00;Bobigny
Pyrénées - Dagorno;20;18;2;2;0;2023-04-05T22:45:38+02:00;Paris
Lavoisier - Missak Manouchian;18;15;3;1;2;2023-04-05T22:42:47+02:00;Rosny-sous-Bois
Flandre - Ourcq;30;6;23;12;11;2023-04-05T22:38:55+02:00;Paris
Saint-Séverin - Saint-Michel;30;11;17;15;2;2023-04-05T22:44:23+02:00;Paris
Point du Jour - Jean Jaurès;26;0;25;18;7;2023-04-05T22:46:10+02:00;Boulogne-Billancourt
Place Aristide Briand;35;13;20;11;9;2023-04-05T22:46:37+02:00;Charenton-le-Pont
Metz - Marne;33;13;18;7;11;2023-04-05T22:45:42+02:00;Paris
Montreuil - République;25;16;9;4;5;2023-04-05T22:45:40+02:00;Vincennes
Bertrand Sincholle - Henri Barbusse;23;7;13;8;5;2023-04-05T22:46:43+02:00;Clichy
Constantine - Université;65;48;13;0;13;2023-04-05T22:44:06+02:00;Paris
Saint-Maur - République;38;9;28;16;12;2023-04-05T22:46:36+02:00;Paris
Pierre Brossolette - 12 Février 1934;25;16;9;5;4;2023-04-05T22:46:25+02:00;Malakoff
Marcel Monge - Marcel Dassault;46;38;5;2;3;2023-04-05T22:45:31+02:00;Suresnes
Guy Môquet - Compoint;36;5;31;23;8;2023-04-05T22:47:06+02:00;Paris
Commandant Charcot - Bretteville;36;1;32;24;8;2023-04-05T22:46:51+02:00;Neuilly-sur-Seine
Championnet.;22;8;11;6;5;2023-04-05T22:47:15+02:00;Paris
Général Michel Bizot - Claude Decaen;38;2;34;27;7;2023-04-05T22:46:10+02:00;Paris
Quatre Vents - Carrefour de l'Odéon;37;31;3;2;1;2023-04-05T22:44:48+02:00;Paris
Ivry - Baudricourt;20;11;7;4;3;2023-04-05T22:46:14+02:00;Paris
Reynaldo Hahn - Lagny;19;17;2;1;1;2023-04-05T22:41:55+02:00;Paris
Lacépède - Linné;54;43;9;5;4;2023-04-05T22:45:41+02:00;Paris
Arthur Auger - Jean Jaurès;26;20;6;2;4;2023-04-05T22:43:16+02:00;Montrouge
Saint-Mandé - Docteur Arnold Netter;39;31;6;2;4;2023-04-05T22:46:49+02:00;Paris
Passy - Place du Costa Rica;33;26;6;2;4;2023-04-05T22:47:10+02:00;Paris
Guynemer - Jardin du Luxembourg;36;29;5;4;1;2023-04-05T22:45:59+02:00;Paris
Guillaume Bertrand - République;38;4;32;18;14;2023-04-05T22:46:41+02:00;Paris
Paul Valery - Victor Hugo;35;31;2;1;1;2023-04-05T22:38:12+02:00;Paris
Jean-Baptiste Charcot - Sainte-Geneviève;21;2;17;10;7;2023-04-05T22:46:47+02:00;Courbevoie
Etienne Dolet - Place Maurice Chevalier;33;2;31;17;14;2023-04-05T22:46:34+02:00;Paris
Marché d'Auteuil;32;11;16;12;4;2023-04-05T22:47:08+02:00;Paris
Pablo Picasso - Maurice Thorez;28;23;4;1;3;2023-04-05T22:43:18+02:00;Bobigny
Pasteur - Cotentin;33;32;1;0;1;2023-04-05T22:46:55+02:00;Paris
Place Tristan Bernard;28;25;2;1;1;2023-04-05T22:44:23+02:00;Paris
Fief - République;25;16;7;5;2;2023-04-05T22:44:05+02:00;Boulogne-Billancourt
Port - Maurice Chevalier;30;30;0;0;0;2022-10-24T10:57:47+02:00;Nogent-sur-Marne
Porte de Charenton;67;58;8;2;6;2023-04-05T22:46:00+02:00;Paris
Résistance - Romain Rolland;28;24;3;0;3;2023-04-05T22:46:30+02:00;Argenteuil
Colisée - Champs-Elysées;24;18;1;0;1;2023-04-05T22:40:18+02:00;Paris
Batignolles - Abel Truchet;28;20;8;3;5;2023-04-05T22:46:11+02:00;Paris
Hôtel de Ville de Rueil-Malmaison;20;3;15;6;9;2023-04-05T22:46:55+02:00;Rueil-Malmaison
Jean Mermoz - Champs-Elysées;33;30;1;0;1;2023-04-05T22:43:01+02:00;Paris
Arsonval - Falguière;25;21;4;1;3;2023-04-05T22:39:21+02:00;Paris
René Boulanger - Lancry;62;50;9;8;1;2023-04-05T22:46:26+02:00;Paris
Bobillot - Moulin des Prés;28;23;3;2;1;2023-04-05T22:46:23+02:00;Paris
Paul Doumer - Stalingrad;24;14;10;4;6;2023-04-05T22:44:32+02:00;Arcueil
Crimée - Ourcq;56;23;30;21;9;2023-04-05T22:45:32+02:00;Paris
Hippodrome de Longchamp;30;9;14;13;1;2023-04-05T22:47:08+02:00;Paris
Jacquier - Didot;30;21;9;8;1;2023-04-05T22:41:07+02:00;Paris
Payenne - Square George Caïn;24;10;10;9;1;2023-04-05T22:43:55+02:00;Paris
Place d'Italie - Soeur Rosalie;52;50;2;0;2;2023-04-05T22:44:23+02:00;Paris
Georges Pompidou - Verdun;26;1;25;14;11;2023-04-05T22:44:15+02:00;Suresnes
Rond-Point Rhin et Danube;53;31;22;21;1;2023-04-05T22:46:51+02:00;Boulogne-Billancourt
Cité de la Musique;60;55;2;0;2;2023-04-05T22:45:37+02:00;Paris
Geoffroy-Saint-Hilaire - Saint-Marcel;17;0;13;12;1;2023-04-05T22:47:07+02:00;Paris
Saint-Antoine Sévigné;26;7;14;12;2;2023-04-05T22:46:01+02:00;Paris
Place Saint-André des Arts;37;21;15;13;2;2023-04-05T22:46:16+02:00;Paris
Macdonald - Césaria Evora;67;62;5;1;4;2023-04-05T22:44:37+02:00;Paris
Saint-Marcel - Hôpital;21;18;2;1;1;2023-04-05T22:40:40+02:00;Paris
Pavé des Gardes - Charles Vaillant;20;19;1;0;1;2023-04-05T22:39:03+02:00;Sèvres
Verdun - Pierre et Marie Curie;26;3;23;8;15;2023-04-05T22:46:43+02:00;Ivry-sur-Seine
Epi d'Or - Chevilly;0;0;0;0;0;2023-03-30T08:59:02+02:00;Villejuif
Temple - Jean-Pierre Timbaud;36;23;10;9;1;2023-04-05T22:44:59+02:00;Paris
Stalingrad - Général de Gaulle;26;1;23;18;5;2023-04-05T22:40:14+02:00;Champigny-sur-Marne
Convention - Campus de Bobigny;32;22;6;2;4;2023-04-05T22:47:00+02:00;Bobigny
Cartier Bresson - Denis Papin;32;28;2;0;2;2023-04-05T22:45:51+02:00;Pantin
Alfred de Vigny - Place du Général Brocard;33;31;1;1;0;2023-04-05T21:16:32+02:00;Paris
Quai des Célestins - Henri IV;14;6;8;8;0;2023-04-05T22:47:11+02:00;Paris
Perrault - Place du Louvre;28;21;1;1;0;2023-04-05T22:44:16+02:00;Paris
Carpeaux - Place Jacques Froment;19;3;15;7;8;2023-04-05T22:47:04+02:00;Paris
Fontaine du Tertre - Calvaire;24;19;5;2;3;2023-04-05T22:45:44+02:00;Suresnes
Jemmapes - Ecluses Saint-Martin;15;5;7;5;2;2023-04-05T22:43:14+02:00;Paris
Place des Arts - Jean Mermoz;20;20;0;0;0;2022-12-07T08:57:34+01:00;Rueil-Malmaison
Président Roosevelt - Rouget de Lisle;0;0;0;0;0;2021-07-28T09:10:05+02:00;Issy-les-Moulineaux
Sèvres - Maréchal Juin;18;0;17;16;1;2023-04-05T22:46:27+02:00;Boulogne-Billancourt
Châteaudun - Place de la Liberté;26;7;16;11;5;2023-04-05T22:44:09+02:00;La Garenne-Colombes
Claude Debussy - Marc Bloch;56;40;10;7;3;2023-04-05T22:46:08+02:00;Clichy
Bastille - Biscornet;62;27;30;30;0;2023-04-05T22:47:12+02:00;Paris
Place Jean Mermoz;30;3;27;16;11;2023-04-05T22:41:33+02:00;Bois-Colombes
Champs de Manoeuvre - Cartoucherie;20;10;9;4;5;2023-04-05T22:45:36+02:00;Paris
Charles de Gaulle - Rue de l'Alma;28;22;4;2;2;2023-04-05T22:45:15+02:00;Courbevoie
Val-Fleury;23;13;7;0;7;2023-04-05T22:45:38+02:00;Meudon
Ménilmontant - Père Lachaise;56;16;38;18;20;2023-04-05T22:47:01+02:00;Paris
Place Henri Dunant - Gare RER;31;23;7;7;0;2023-04-05T22:44:03+02:00;Fontenay-aux-Roses
Gare du Nord - Dunkerque;29;22;5;2;3;2023-04-05T22:44:13+02:00;Paris
Guy Môquet - Jean Moulin;30;19;7;7;0;2023-04-05T22:45:01+02:00;Saint-Denis
Gare RER les Ardoines;49;34;15;13;2;2023-04-05T22:45:17+02:00;Vitry-sur-Seine
Avenir;45;44;1;1;0;2023-04-05T22:46:24+02:00;Châtillon
Gare du Nord - Faubourg Saint-Denis;28;22;3;2;1;2023-04-05T22:45:07+02:00;Paris
Gare Saint-Lazare - Place de Budapest;44;40;2;2;0;2023-04-05T22:46:32+02:00;Paris
Pyrénées - Ménilmontant;26;11;14;1;13;2023-04-05T22:46:48+02:00;Paris
Garibaldi - Gabriel Péri;30;6;22;10;12;2023-04-05T22:45:52+02:00;Saint-Ouen-sur-Seine
8 Mai 1945 - 10 Juillet 1940;30;5;22;16;6;2023-04-05T22:47:04+02:00;Vitry-sur-Seine
Bateliers - Quai de Seine;26;10;13;7;6;2023-04-05T22:42:51+02:00;Saint-Ouen-sur-Seine
Musée d'Orsay;65;62;2;2;0;2023-04-05T22:47:01+02:00;Paris
Aristide Briand - Place de la Résistance;25;5;19;18;1;2023-04-05T22:45:19+02:00;Issy-les-Moulineaux
Félix Faure - Lourmel;58;1;56;54;2;2023-04-05T22:45:22+02:00;Paris
Roland Garros - Jean Bouin;28;18;9;2;7;2023-04-05T22:46:43+02:00;Châtillon
Gambetta - Saint Fargeau;24;11;13;1;12;2023-04-05T22:44:53+02:00;Paris
Simone Signoret - Paris;28;9;18;13;5;2023-04-05T22:46:25+02:00;Noisy-le-Sec
Galilée - Vernet;17;15;1;1;0;2023-04-05T22:37:46+02:00;Paris
Caumartin - Provence;22;19;2;1;1;2023-04-05T22:45:10+02:00;Paris
Gare RER - Général de Gaulle;41;15;24;21;3;2023-04-05T22:43:52+02:00;Gennevilliers
Sebastopol - Rambuteau;16;14;1;1;0;2023-04-05T22:47:14+02:00;Paris
Chevaleret - Tolbiac;21;20;1;0;1;2023-04-05T22:45:00+02:00;Paris
Gare de l'Est - Chateau Landon;59;50;8;3;5;2023-04-05T22:43:14+02:00;Paris
Saint-Lazare - Place d'Estienne d'Orves;39;22;5;3;2;2023-04-05T22:44:11+02:00;Paris
Jonquière - Docteur Paul Brousse;40;5;26;20;6;2023-04-05T22:45:47+02:00;Paris
Nungesser - Santé;22;8;13;1;12;2023-04-05T22:44:48+02:00;Fontenay-sous-Bois
Ordener - Poissonniers;35;17;17;6;11;2023-04-05T22:45:26+02:00;Paris
Dora Maar - Nadia Guendouz;30;21;6;3;3;2023-04-05T22:46:40+02:00;Saint-Ouen-sur-Seine
Ruisseau - Ordener;35;1;30;12;18;2023-04-05T22:46:23+02:00;Paris
Louis Armand - Bernard Palissy;0;0;0;0;0;2023-01-25T15:17:38+01:00;Asnières-sur-Seine
Clignancourt - Ordener;35;17;18;8;10;2023-04-05T22:45:50+02:00;Paris
Ménil - Argenteuil;20;1;18;11;7;2023-04-05T22:44:52+02:00;Asnières-sur-Seine
Westermeyer - Paul Vaillant-Couturier;25;1;24;15;9;2023-04-05T22:45:04+02:00;Ivry-sur-Seine
Jean Bouin - Gouverneur Général Eboué;0;0;0;0;0;2023-04-03T08:03:51+02:00;Issy-les-Moulineaux
Malesherbes - Place de la Madeleine;67;61;4;1;3;2023-04-05T22:42:47+02:00;Paris
Stalingrad - Barbara;0;0;0;0;0;2023-03-29T12:26:44+02:00;Bagneux
Lamarck - Saint-Ouen;40;20;19;11;8;2023-04-05T22:45:34+02:00;Paris
Richard Lenoir - Place de la Bastille;53;38;1;1;0;2023-04-05T22:47:16+02:00;Paris
Verdun - Henri Barbusse;24;24;0;0;0;2023-04-05T22:39:16+02:00;Bagneux
Enfants du Paradis - Peupliers;40;34;1;1;0;2023-04-05T22:44:58+02:00;Boulogne-Billancourt
Maréchal Leclerc de Hauteclocque - Marché Buzenval;30;28;2;0;2;2023-04-05T22:45:33+02:00;Rueil-Malmaison
Gare Saint-Lazare - Cour du Havre;45;40;1;0;1;2023-04-05T22:46:54+02:00;Paris
Bercy - Villot;34;26;9;7;2;2023-04-05T22:46:01+02:00;Paris
Saint-Germain - Verdun;30;30;0;0;0;2023-02-07T15:46:08+01:00;Romainville
Jean Jaurès - Place du Dr Roux;35;16;18;10;8;2023-04-05T22:42:30+02:00;Gennevilliers
Pierre Ginier - Clichy;16;12;3;0;3;2023-04-05T22:46:13+02:00;Paris
Place du Colonel Fabien;27;13;13;7;6;2023-04-05T22:46:27+02:00;Paris
Faubourg St-Antoine - Place de la Nation;16;5;10;10;0;2023-04-05T22:45:13+02:00;Paris
Charles de Gaulle - Madrid;22;17;4;3;1;2023-04-05T22:45:48+02:00;Neuilly-sur-Seine
Gare de Lyon - Roland Barthes;68;31;35;33;2;2023-04-05T22:45:49+02:00;Paris
Parc des Pierrettes;23;17;6;6;0;2023-04-05T22:38:22+02:00;Châtillon
Division Leclerc - Kléber;25;21;4;0;4;2023-04-05T22:37:34+02:00;Châtillon
Place Balard;22;17;4;2;2;2023-04-05T22:46:58+02:00;Paris
Hélène et François Missoffe - Emile Borel;32;30;1;1;0;2023-04-05T22:44:22+02:00;Paris
Adrien Lesesne - Docteur Bauer;30;0;29;12;17;2023-04-05T22:47:01+02:00;Saint-Ouen-sur-Seine
Porte de Clichy - Place des Nations Unies;40;25;12;6;6;2023-04-05T22:42:05+02:00;Paris
Henri Barbusse - Bourguignons;34;2;32;14;18;2023-04-05T22:44:41+02:00;Asnières-sur-Seine
Marceau Delorme - Pierre Brossolette;28;5;16;14;2;2023-04-05T22:46:12+02:00;Asnières-sur-Seine
Gare RER;30;10;19;4;15;2023-04-05T22:43:27+02:00;Noisy-le-Sec
Place de la Paix - Abbé Saint-Pierre;24;19;4;0;4;2023-04-05T22:46:27+02:00;Suresnes
BNF - Bibliothèque Nationale de France;42;36;5;4;1;2023-04-05T22:47:02+02:00;Paris
